Genehmigung des Protokolls der vorangegangenen Sitzung	Adoption of the Minutes of the previous sitting
Das Protokoll von gestern wurde verteilt.	The Minutes of yesterday' s sitting have been distributed.
Gibt es Einwände?	Are there any comments?
Herr Präsident, nach der Abstimmung über den Haushaltsplan erlebten wir gestern einen besonderen Augenblick insofern, als die drei beteiligten Institutionen durch weibliche Repräsentantinnen vertreten waren, und die Präsidentin sprach am Schluß von einem guten Ende des Jahrtausends.	Mr President, yesterday, at the end of the vote on the budget, there was a moment when the three institutions concerned were represented by women and the President concluded by saying that the Millennium was ending on a high note.
Ich wollte lediglich, wie es vor kurzem auch das angesehene Greenwich-Observatorium getan hat, darauf hinweisen, daß das Jahrtausend am 31. Dezember 2000 zu Ende gehen wird.	I just wanted to mention that, as the authoritative Greenwich Observatory has also pointed out, the Millennium will end on 31 December 2000.
Herr Speroni, ich bin mir bewußt, daß Sie vom rationalen und kartesianischen Standpunkt völlig recht haben.	Mr Speroni, I am aware that, from a rational and Cartesian point of view, you are absolutely right.
Wissenschaftlich betrachtet haben Sie recht.	Scientifically you are right.
Aber aus der Sicht des Volksglaubens endet das Millennium in 14 Tagen.	However, according to popular belief, the Millennium ends in 14 days.
Deshalb wird Ihre Überlegung im Protokoll stehen, aber ich glaube, jeder wird es zumindest am 31. Dezember dieses Jahres und möglicherweise zweimal feiern.	Therefore, your comments will appear in the Minutes, but I believe that everybody will hold celebrations, at least, on 31 December of this year and then, possibly, a second time.
Das gibt mir die Möglichkeit, Ihnen zu sagen, daß die Präsidentin heute bei Ihnen sein wollte, aber leider ist, wie Sie wissen, ihre Gesundheit in diesen Tagen angegriffen, und deshalb möchte ich Ihnen allen in ihrem Namen, in dem des Präsidiums und in meinem eigenen Namen die besten Wünsche für dieses Weihnachtsfest, für das kommende Jahr und, ich wollte auch sagen, das nächste Jahrtausend, zum Ausdruck bringen.	I would like to take this opportunity to tell you that the President would have liked to have been with you today but, unfortunately, as you know, she is not very well at the moment and therefore, on her behalf, on behalf of the Bureau and on my own behalf, I would like to wish you all the best for this Christmas, this new year and, I was going to say, this new Millennium.
Auf jeden Fall, im Namen des Präsidiums frohe Weihnachten und ein glückliches Neues Jahr, und gestatten Sie mir, es einmal in meiner eigenen Sprache zu sagen: "Bon Nadal i feliç Any Nou ".	In any case, personally, I was convinced that I was going to be the last President of the Millennium.
(Beifall) (Das Parlament genehmigt das Protokoll.)	In any event, on behalf of the Bureau, Merry Christmas and a Happy New Year and, on this one occasion, allow me to wish you, in my own Catalan language: 'Bon Nadal i feliç Any Nou' .
Internationaler Fonds für Irland	(Applause) (The Minutes were approved)
Herr de Rossa bittet mich um das Wort zur Geschäftsordnung.	International Fund for Ireland
De Rossa (PSE).	Mr De Rossa has requested the floor for a procedural motion.
(EN) Herr Präsident, zur Geschäftsordnung möchte ich die Frage stellen, ob die zu diesem Vorschlag eingereichten Änderungsanträge der Geschäftsordnung entsprechen.	De Rossa (PSE).
Dies ist ein Vorschlag ohne Aussprache, und wir werden daher keine Gelegenheit haben, die vorliegenden Änderungsanträge zu erörtern.	Mr President, on a point of order, I wish to raise the question as to whether or not the amendments which have been tabled in relation to this proposal are in order.
Ich unterstütze die Änderungsanträge zwar nicht, aber offenbar befinden wir uns jetzt in der mißlichen Lage, über Änderungsanträge abstimmen zu müssen, ohne daß wir die Gelegenheit zu ihrer Erörterung erhalten haben.	This is a proposal without debate and we will not have any opportunity therefore to debate the amendments being put forward.
Herr Präsident, zur Geschäftsordnung.	I happen to oppose the amendments but it seems to be that we have been put in an invidious position, asking us to vote on amendments which we have not had an opportunity to debate.
Ich möchte das Hohe Haus informieren, daß die Änderungsanträge der Geschäftsordnung entsprechen.	Mr President, on a point of order, I should like to inform the House that the amendments are in order.
Sie stehen im Einklang mit dem Verfahren.	They are in line with the procedure.
Es stimmt, daß es weitaus besser gewesen wäre, wenn wir die Gelegenheit gehabt hätten, dies im Ausschuß zu erörtern, und dies wäre, wie bereits zu Beginn dieser Woche gesagt wurde, eine viel bessere Gelegenheit gewesen, eine Aussprache über dieses Thema zu führen.	It is true that it would have been much better had we had an opportunity to debate this in committee and, as was said at the beginning of the week, that would have been a much better opportunity to have the issue debated.
Doch leider ist beschlossen worden, dies ohne Aussprache durchzuführen, aber die Änderungsanträge stehen trotzdem im Einklang mit der Geschäftsordnung.	Unfortunately, the decision was taken that this would be put without debate and the amendments are in order.
Sie sind äußerst wichtig.	They are extremely important.
Herr Präsident, so wie Herr de Rossa bezweifle auch ich, ob die Änderungsanträge der Geschäftsordnung entsprechen.	Mr President, like Mr De Rossa I also question the fact of the amendments being in order.
Die sensible Lage in Nordirland ist viel zu wichtig, als daß zugelassen werden dürfte, daß aufgrund mangelhafter Informiertheit lautstark gegen den Internationalen Fonds für Irland vorgegangen wird.	The sensitivities of Northern Ireland are too important for any ill-informed bandwagoning on the International Fund for Ireland.
Ich ersuche Sie, unser Vorgehen in dieser Angelegenheit sehr genau abzuwägen, zumal es keine Aussprache geben wird.	I would ask you to consider very carefully how we proceed here, particularly as we are not in a position to have a debate.
Ich schließe mich den Bedenken meiner Kollegen, der Herrn de Rossa und McCartin, an.	I share this concern with my colleagues, Mr De Rossa and Mr McCartin.
Raytheon wurde in Derry von niemand Geringerem als den Nobelpreisträgern John Hume - einem unserer Abgeordnetenkollegen - und David Trimble willkommen geheißen.	Raytheon has been welcomed to Derry by no less than Nobel Peace Prize winners, John Hume - one of our own colleagues, and David Trimble.
Raytheon wird vom Industrial Development Board for Northern Ireland finanziert.	Raytheon will be funded by the Industrial Development Board in Northern Ireland.
Nicht ein Euro bzw. ein irisches Pfund aus dem Internationalen Fonds für Irland gelangen zu Raytheon.	Not one euro nor one Irish pound from the International Fund for Ireland is going to Raytheon.
Die Änderungsanträge sind absolut unangemessen.	The amendments are totally inappropriate.
Meine Damen und Herren!	Ladies and gentlemen, Messrs Cashman and Simpson have also requested the floor, but I would be grateful if we could concentrate on the task in hand.
Auch die Herren Cashman und Simpson haben mich um das Wort gebeten, aber ich wäre Ihnen dankbar, wenn wir uns auf die Arbeit konzentrieren würden.	The truth, and this may remove the need for the Members' procedural motions, is that it was Parliament that decided on Tuesday not to hold the debate.
Tatsache ist, und das macht die Geschäftsordnungsfragen der Kollegen vielleicht hinfällig, daß dieses Plenum am Dienstag beschlossen hat, daß es keine Debatte gibt.	Therefore, this President, although he might like to reverse this decision, is not going to do so.
Deshalb werde ich dies als Präsident nicht ändern, auch wenn ich es möchte.	This is clear.
Das versteht sich.	This is the decision of Parliament, and furthermore, incidentally, Mrs Doyle, I was rapporteur when this fund was approved for the first time and there was a long debate at the time about its creation.
Es ist die Entscheidung des Plenums, und außerdem war ich zufällig, Frau Doyle, Berichterstatter, als dieser Fonds zum ersten Mal beschlossen wurde, und es fand damals eine lange Aussprache über die Bildung dieses Fonds statt.	Therefore, I am sorry to say that we cannot make changes now.
Deshalb bedauere ich, daß wir jetzt keine Änderungen vornehmen können.	Mr Simpson has the floor.
Das Wort hat Herr Simpson.	Mr President, it is not my intention to delay the House any longer than we have to.
Herr Präsident, ich beabsichtige nicht, das Hohe Haus länger als unbedingt nötig aufzuhalten.	I do not want to get into the argument about the amendments because that can be sorted out by a vote.
Ich möchte mich nicht der Diskussion über die Änderungsanträge anschließen, da dies durch eine Abstimmung geklärt werden kann.	One point should be made, however; the process is not ideal.
Jedoch sollte eines klar gesagt werden.	Mrs Doyle and other Members are right but the problem we are faced with in the Regional and Transport Committee, which is the committee responsible, is that at the very last minute we were asked for urgency by the Council because somebody, somewhere, realised that we needed a resolution from this House to carry on the particular fund in question.
Das Verfahren ist nicht vollkommen, da haben Frau Doyle und die anderen Abgeordneten recht, aber das Problem, mit dem wir uns im Ausschuß für Regionalpolitik, Verkehr und Fremdenverkehr als dem federführenden Ausschuß konfrontiert sehen, besteht darin, daß wir im allerletzten Augenblick vom Rat um Dringlichkeit ersucht wurden, da irgendwo jemandem aufgefallen war, daß wir eine Entschließung in diesem Hause benötigten, um diesen Fonds weiterführen zu können.	Therefore, the only way we could do that was by this very quick procedure, through the committee on Tuesday, by a letter from the President.
Die einzige Möglichkeit bestand für uns daher darin, dies am Dienstag über den Ausschuß mittels eines Schreibens des Präsidenten in diesem Schnellverfahren abzuwickeln.	We thought we had an understanding that there would not be any amendments.
Wir waren der Auffassung, wir hätten vereinbart, daß es keine Änderungsanträge geben würde.	Sadly, that has not been the case.
Bedauerlicherweise wurde dies nicht eingehalten.	It is only fair to point out that given the time we had to do this, the committee and the Parliament have worked as effectively and as quickly as we possibly can in what proved to be difficult circumstances so that the money could be released next year for this very important fund.
Daher ist es nur gerechtfertigt, darauf hinzuweisen, daß der Ausschuß und das Parlament in der hierfür zur Verfügung stehenden Zeit so effektiv und schnell wie es irgend möglich war und unter schwierigen Umständen gearbeitet haben, damit das Geld im kommenden Jahr für diesen so wichtigen Fonds zur Verfügung gestellt werden kann.	Thank you very much, Mr Simpson.
Vielen Dank, Herr Simpson.	Before the plenary session, both the services and the Presidency examined the comments on the admissibility or otherwise of the amendments.
Die Bemerkungen über die verfahrensmäßige Zulässigkeit oder Unzulässigkeit der Änderungsanträge sind sowohl von den Diensten als auch von der Präsidentschaft vor dem Plenum geprüft worden.	Political evaluation is one thing but the technical possibility of admitting amendments is another thing altogether.
Die politische Bewertung ist die eine Sache, eine andere ist die technische Möglichkeit der Zulassung der Änderungsanträge.	In accordance with the Rules of Procedure, they are perfectly permissible.
Aus der Sicht der Geschäftsordnung sind sie völlig ordnungsgemäß.	Therefore, we shall now proceed to the vote on the proposed regulation.
Deshalb stelle ich den Verordnungsvorschlag zur Abstimmung.	(Parliament approved the Commission' s proposal) EXPLANATIONS OF VOTE
(Das Parlament billigt den Vorschlag der Kommission.)	- The amendments are inadmissible on the following grounds: the objectives of the Fund do not include promoting large-scale inward investment.
Erklärungen zur Abstimmung	The Fund exists to promote urban and rural development, community development, to enhance skills and to improve the environment; the justifications cited in the Green amendments are spurious.
Die Änderungsanträge sind aus folgenden Gründen unzulässig: Die Zielsetzungen des Fonds beinhalten nicht die Förderung umfangreicher Investitionszuflüsse aus dem Ausland.	The Fund has no role in the Raytheon project, nor could it have.
Der Fonds wurde eingerichtet, um die städtische und ländliche Entwicklung sowie die kommunale Entwicklung zu fördern, zur Anhebung des Qualifikationsniveaus beizutragen und Umweltschutzmaßnahmen umzusetzen.	The amendments simply seek to prevent the Fund from doing something which it could not do anyway; the purpose of the proposed Regulation is to permit the continuation of the financial contribution of the EU to the Fund; it does not in any way seek to amend the substance of the existing Regulation EC 2614/97, which is why the urgency procedure was agreed in the first place.
Die im Änderungsantrag der Grünen genannten Begründungen sind haltlos, der Fonds spielt im Raytheon-Projekt keine Rolle, und er könnte es auch gar nicht.	On the matters of substance, the projects referred to in the Green justification are not military projects.
In den Änderungsanträgen wird lediglich versucht, den Fonds von etwas abzuhalten, was für ihn ohnehin nicht in Frage käme.	- The vote on the fund which was tabled late by the Council was facilitated by the EP without debate, on the understanding from all groups including the Greens that there would be no amendments.
Zweck der vorgeschlagenen Verordnung ist es, die Fortführung der finanziellen Unterstützung der EU an den Fonds zu ermöglichen, der Inhalt der bestehenden Verordnung EG 2614/97 soll in keiner Weise verändert werden, weshalb das Dringlichkeitsverfahren zunächst angenommen wurde.	It would seem that at the instigation of Ms Patricia McKenna, the Greens broke this understanding.
Was den Inhalt anbelangt, so sind die in der Begründung der Grünen genannten Projekte nicht militärischer Art.	As a consequence of this I was being asked to vote on amendments which I had not had the opportunity to consult about or research and on which I would be precluded from debating on the floor of the House.
Die Abstimmung über den Vorschlag für eine Verordnung des Rates über Finanzbeiträge der Gemeinschaft zum Internationalen Fonds für Irland, der vom Rat erst spät vorgelegt wurde, ist vom EP ohne Aussprache unter der von allen Fraktionen, darunter auch der Grünen, akzeptierten Bedingung ermöglicht worden, daß es keine Änderungsanträge geben würde.	The company criticised in the amendments (Raytheon) was in fact welcomed by two Nobel Peace Prize winners (Hume/Trimble).
Es sieht so aus, daß sich die Grünen auf Betreiben von Frau Patricia McKenna nicht an diese Abmachung gehalten haben.	In addition, if we are to shut down or refuse investment from every company which may have an association with the arms industry, then we would have to close virtually every American and Japanese software company on the island of Ireland with catastrophic consequences.
Infolgedessen soll ich über Änderungsanträge abstimmen, zu denen ich mich nicht beraten und keine Nachforschungen anstellen konnte und auch nicht die Möglichkeit erhalte, sie hier in diesem Plenum zu erörtern.	I am opposed to the arms industry but we must not put at risk the economic prosperity of Northern Ireland with ill-conceived and badly researched amendments in the European Parliament.
Das in den Änderungsanträgen kritisierte Unternehmen (Raytheon) wurde sogar von zwei Nobelpreisträgern (Hume/Trimble) begrüßt.	- The EUR 45 million to the IFI is most welcome, and a continuing recognition of the European Union's support for the cross-border communities in Ireland.
Wenn wir zudem jedes Unternehmen, das auf irgendeine Weise mit der Rüstungsindustrie verbunden ist, schließen oder Investitionen dieser Unternehmen unterbinden, dann müßten wir so ziemlich alle amerikanischen und japanischen Softwareunternehmen auf der irischen Insel schließen, was katastrophale Auswirkungen hätte.	Any attempt to sully the reputation of the IFI is totally unacceptable and amounts to ill-informed political bandwagoning on the sensitivities of Northern Ireland and are not worthy of this Parliament.
Ich lehne die Rüstungsindustrie ab, jedoch dürfen wir die wirtschaftliche Prosperität Nordirlands nicht durch falsch verstandene und schlecht recherchierte Änderungsanträge im Europäischen Parlament gefährden.	For the record, Raytheon, a high-tech software plant to which the amendments are directed, is to be funded by the IDB, the Industrial Development Board in Northern Ireland, not the IFI.
Die 45 Mio. Euro für den Internationalen Fonds für Irland (IFI) sind sehr willkommen und bedeuten eine weitere Anerkennung der Unterstützung der Europäischen Union für die Gemeinden beiderseits der Grenze in Irland.	Community agricultural statistics
Jeglicher Versuch, das Ansehen des IFI zu beschmutzen, ist völlig inakzeptabel und läuft darauf hinaus, aufgrund mangelhafter Informiertheit lautstark politisches Kapital aus der heiklen Lage in Nordirland schlagen zu wollen.	The next item is the debate on the report (A5-0089/1999) by Mrs Redondo Jiménez, on behalf of the Committee on Agriculture and Rural Development, on the proposal for a European Parliament and Council decision amending Decision 96/411/EC on improving Community agricultural statistics [COM(1999) 332 - C5­0042/1999 - 1999/0137(COD)].
Dieses Vorgehen ist dieses Parlaments nicht würdig.	Mr President, the Commission proposes extending Decision 96/411 until 2002, removing certain articles in order to simplify its implementation and bringing forward the payment of 30% of the Community contribution to the Member States, and to do all of this in accordance with the codecision procedure.
Speziell sei darauf hingewiesen, daß Raytheon, eine Hightech-Softwareschmiede, um die es in den Änderungsanträgen geht, vom IDB, dem Industrial Development Board for Northern Ireland, und nicht vom IFI finanziert wird.	In 1997 an amendment to this Decision was presented which extended by two years the deadline for Member States to send their reports and the deadline for the Commission to draw up a progress report for Parliament and for the Council.
Agrarstatistik der Gemeinschaft	Given the importance of the common agricultural policy, the availability to everybody of reliable information for the purposes of decision making is essential.
Nach der Tagesordnung folgt die Aussprache über den Bericht (A5-0089/1999) von Frau Redondo Jiménez im Namen des Ausschusses für Landwirtschaft und ländliche Entwicklung über den Vorschlag für eine Entscheidung des Europäischen Parlaments und des Rates zur Änderung der Entscheidung 96/411/EG zur Verbesserung der Agrarstatistik der Gemeinschaft (KOM(1999) 332 - C5­0042/1999 - 1999/0137(COD))	Therefore, it must be a priority for the institutions to provide the means for this information to be ever more complete, reliable and quick, and therefore agricultural statistics must be ever more flexible, harmonious and coherent with other statistical fields with the possibility of incorporating new sources.
.	To this end, we have to identify, firstly, the areas in which it is possible to implement rationalisation measures, secondly, areas where there are new and increasing needs, and thirdly, general principles in accordance with which actions are carried out.
(ES) Herr Präsident!	Having said this, it should not be necessary to point out that all the Member States should act in accordance with these intentions.
Die Kommission schlägt vor, die Entscheidung 96/411 bis zum Jahr 2002 zu verlängern, bestimmte Artikel zur Vereinfachung ihrer Anwendung zu streichen und 30 % des Gemeinschaftsbeitrags an die Mitgliedstaaten im voraus auszuzahlen, und dies alles im Mitentscheidungsverfahren.	However, this is not the case: this is a voluntary programme for the Member States.
1997 wurde eine Änderung dieser Entscheidung vorgelegt, durch welche die Frist für die Einreichung der Berichte durch die Mitgliedstaaten und der der Kommission zur Erarbeitung des Berichts über den Fortschritt für das Parlament und den Rat zur Verfügung stehende Zeitraum um zwei Jahre verlängert wurde.	I would like to stress that it is not at all easy for this Parliament to understand that any Member State might say "I am not interested, I am not taking part" .
In Anbetracht der Bedeutung der gemeinsamen Agrarpolitik steht die Notwendigkeit, zum Zeitpunkt der Entscheidungsfindung über verläßliche Daten zu verfügen, außer Frage.	The common agricultural policy belongs to all the Member States.
Deshalb muß eine vorrangige Aufgabe der Institutionen darin bestehen, die Mittel bereitzustellen, damit diese Daten immer vollständiger, verläßlicher und schneller verfügbar sind, weshalb die Agrarstatistiken immer flexibler, harmonischer und mit anderen statistischen Bereichen immer enger verbunden sein müssen, wobei die Möglichkeit der Einbeziehung neuer Quellen gegeben sein muß.	It affects all of us.
Dazu müssen zum ersten die Gebiete, auf denen Rationalisierungsmaßnahmen getroffen werden können, zweitens die Bereiche, in denen es neuen oder wachsenden Bedarf gibt, und drittens die allgemeinen Kriterien, nach denen die durchzuführenden Aktionen auszurichten sind, bestimmt werden.	Therefore, I would like both the Commission and the Council to reconsider the matter and for the next proposal submitted to this Parliament to establish the obligatory nature of its application in all Member States, with a single legal basis in the statistical field.
Dies vorausgeschickt, erübrigt es sich darauf hinzuweisen, daß sich alle Mitgliedstaaten an diese Absichten halten müßten.	There is another aspect which I would like to point out to the Commission and the Council with regard to amendment 5, which I hope will be taken into account, given that the information requested in it, according to Regulation (EC) 1390/99, which entered into force on 23 November 1999, establishes in article 2 that "each Member State will provide the Commission with all the information classified by budgetary items which will be forwarded at the request of the Commission within 30 days" .
Aber dem ist nicht so: Dies ist ein freiwilliges Programm für die Mitgliedstaaten.	Therefore, I request a specific commitment by the Commission that it will define each year, amongst the priority plans for technical action proposed to it by the Standing Committee on Agricultural Statistics, the things requested in our Amendments Nos 4 and 5, since otherwise, the codecision procedure would be delayed and it would become more difficult for the Member States to draw up their statistical reports.
Ich möchte betonen, daß es für dieses Parlament keineswegs leicht zu verstehen ist, wenn ein Mitgliedstaat sagen würde, "das interessiert mich nicht, ich nehme nicht teil ".	Therefore, I would like to hear the Commission' s opinion with regard to this point in the debate.
Die gemeinsame Agrarpolitik ist die aller Mitgliedstaaten, sie geht uns alle an.	Mr President, I want to thank Mrs Redondo for her report and for her excellent explanation of what all this is about and why it is important.
Deshalb möchte ich, daß sowohl die Kommission als auch der Rat das Thema überdenken und mit dem nächsten Vorschlag, der diesem Parlament unterbreitet wird, dieVerbindlichkeit der Anwendung in allen Mitgliedstaaten mit einer einheitlichen Rechtsgrundlage in der Frage der Statistik festgelegt wird.	One of the things that I miss from the information we were given is the cost of this operation or what the cost would be if every Member State involved themselves in it.
Es gibt einen weiteren Aspekt, auf den ich die Kommission und den Rat im Zusammenhang mit dem Änderungsantrag 5 hinweisen möchte, von dem ich hoffe, daß er Berücksichtigung findet, denn bezüglich der darin geforderten Daten wird in Artikel 2 der am 23. November 1999 in Kraft getretenen Verordnung (EG) 1390/99 festgelegt, daß jeder Mitgliedstaat sämtliche Daten, geordnet nach Haushaltspositionen, für die Kommission bereithält und sie der Kommission auf deren Ersuchen innerhalb von höchstens 30 Tagen übermittelt.	I do not suppose it is very big.
Deshalb ersuche ich um eine ausdrückliche Verpflichtung der Kommission, in den ihr vom ständigen Agrarstatistischen Ausschuß vorgeschlagenen technischen Aktionsplänen jährlich die in unseren Änderungsanträgen 4 und 5 enthaltenen Forderungen zu definieren, da sich der Mitentscheidungsprozeß für uns ansonsten in die Länge ziehen und dies den Mitgliedstaaten die Erarbeitung ihrer statistischen Berichte erschweren würde.	Nevertheless the information is necessary for a Parliament discussing the subject.
Deshalb hoffe ich und würde ich mich freuen, in dieser Aussprache die Meinung der Kommission zu diesem Punkt zu erfahren.	Of course, as the common agricultural policy develops from a situation in which we pay subsidies at the point of export or at the point of entry into intervention into a situation where we pay subsidies for individual animals on an acreage or the hectarage of crop planted, obviously it is extremely important that we know exactly how many animals there are in the Union, how many hectares and how many olive trees and all the rest of it.
Herr Präsident, ich möchte Frau Redondo für ihren Bericht und ihre ausgezeichnete Erklärung dessen, worum es hier geht und weshalb es so wichtig ist, danken.	All that information is extremely important.
In den uns nun vorliegenden Informationen vermisse ich allerdings unter anderem die Kosten dieses Verfahrens bzw. die Kosten, die auf jeden Mitgliedstaat zukommen, der sich selbst daran beteiligt.	It is extremely regrettable if we, at European level, the institutions who organise the common agricultural policy on which the farmers of the Union depend for their livelihood, cannot obtain correct information on which to base an effective policy.
Ich glaube nicht, daß sie sehr hoch sind, aber die Information ist für ein Parlament, das dieses Thema erörtert, trotzdem erforderlich.	It is very hard to understand why we do not have better cooperation from all the Member States.
Da sich die Gemeinsame Agrarpolitik nunmehr aus einer Situation wegentwickelt, in der wir Subventionen zum Zeitpunkt des Exports oder zum Zeitpunkt von Interventionen zahlen, und eine Richtung eingeschlagen wird, im Rahmen derer Subventionen für einzelne Tiere je Fläche bzw. für die Anbaufläche der entsprechenden Kulturen gezahlt werden, ist es natürlich äußerst wichtig, genau zu wissen, wie viele Tiere es in der Union gibt, wieviel Hektar, wie viele Olivenbäume usw. Alle diese Angaben sind enorm wichtig.	When we expand the European Union, or even without expansion, we will not retain all the provisions of the present policy.
Es ist zutiefst bedauerlich, daß wir, die Institutionen, die die Gemeinsame Agrarpolitik auf europäischer Ebene organisieren, von der der Lebensunterhalt der europäischen Landwirte abhängt, keine genauen Informationen erlangen können, um auf deren Basis eine wirksame Politik zu betreiben.	Nevertheless, we will need this information so that we are able to extend some sort of assistance on a reasonable basis to the new countries of the Union where food production and agricultural production will increase by 50 per cent what we have in the Union today.
Es ist nur schwer verständlich, weshalb die Mitgliedstaaten nicht besser mitarbeiten.	It is also advisable to remember that in the Court of Auditors' report, which has just come out and which was debated this week, we did not find in the whole agricultural sector any indication of massive racketeering or fraud on a large scale but we notice that there seem to be an awful lot of little problems with the number of livestock and the amount of hectarage for area aid and so on.
Wenn wir zur Erweiterung der Europäischen Union schreiten - und selbst ohne die Erweiterung - werden wir nicht alle gegenwärtig geltenden politischen Bestimmungen beibehalten können.	There are small errors over a very wide area and that is a serious problem that we have to address.
Trotzdem werden wir diese Informationen benötigen, um den zukünftigen Mitgliedstaaten der Union einige Hilfestellung auf einer vernünftigen Grundlage zukommen lassen zu können, denn die Lebensmittel- und Agrarproduktion wird um 50 % des heutigen Standes in der Union zunehmen.	Finally, I would say that in the new Europe it is going to be important for farmers to base their levels of production on the projected quantities that will be produced in the Union.
Wir sollten uns ebenso in Erinnerung rufen, daß der soeben erschienene Bericht des Rechnungshofs, der in dieser Woche erörtert wurde, keinen einzigen Hinweis auf größere Unterschlagungen oder Betrug in großem Stil im gesamten Agrarsektor enthält.	That cannot happen if we do not know the statistics of the agricultural industry.
Jedoch stellen wir fest, daß es bei der Anzahl der Tiere, der Größe der für die Hektarbeihilfe in Frage kommenden Anbaufläche usw. eine Vielzahl kleinerer Probleme zu geben scheint.	Increasingly, rather than screaming at the institutions of Union to solve the problems, farmers will have to come together and try to calculate what the needs of the market are and produce for those needs.
In einem äußerst umfassenden Bereich häufen sich viele kleine Unzulänglichkeiten, und dies ist ein ernstes Problem, das wir bewältigen müssen.	That does not mean that we want to bring an end to subsidisation.
Abschließend möchte ich bemerken, daß es im neuen Europa für die Landwirte sehr wichtig sein wird, ihr Produktionsniveau auf die in der Union geplanten Mengen auszurichten.	For example, there is the pigmeat industry where we produce 18 million tons of pigmeat annually and we end up in a situation where there is a million tons in surplus.
Dies wird nicht möglich sein, wenn uns keine Agrarstatistik zur Verfügung steht.	Prices collapse, there is terrible hardship and indeed terrible profiteering by middlemen.
Anstatt die Einrichtungen der Union um die Lösung der Probleme anzurufen, werden sich die Landwirte sich häufiger zusammensetzen müssen und den Bedarf des Marktes analysieren, um genau dafür zu produzieren.	If we had good statistics, we would be able to deal with a problem like that before it arose.
Das heißt nicht, daß wir die Subventionen stoppen wollen.	Mr President, I would first like to thank the rapporteur, Mrs Redondo Jiménez, for this report and her excellent display of cooperation as chair of the Committee on Agriculture and Rural Development this autumn.
Nehmen wir z. B. den Schweinefleischsektor, der jährlich 18 Mio. t Schweinefleisch produziert, was aber eine Million Tonnen zuviel ist.	A viable system for statistics is an important basis for making good decisions.
Die Preise purzeln, für die Landwirte wird es schwierig, doch die Zwischenhändler erzielen außerordentlich gute Gewinne.	Statistics have to be comprehensive, reliable and consistent.
Hätten wir eine aussagekräftige Statistik, so könnten wir ein solches Problem angehen, bevor es überhaupt entsteht.	The report quite clearly explains the legal basis of statistics, especially in Amendments Nos 2 and 3, which specify the Community' s share of the advance.
Herr Präsident, zunächst danke ich der Berichterstatterin Redondo Jiménez für diesen Bericht und insbesondere für die gute Zusammenarbeit in ihrer Eigenschaft als stellvertretende Vorsitzende des Ausschusses für Landwirtschaft und ländliche Entwicklung während dieser Sitzungsperiode.	Politically, the most important message is contained in Amendments Nos 4 and 5, which urges the practice of cross-tabulating subsidies received according to, inter alia, farm surface area.
Eine funktionierende Statistik ist eine wichtige Grundlage für ordentliche Beschlüsse.	This information will be especially important when we consider the social side of agricultural subsidies.
Die Statistiken sollten repräsentativ, zuverlässig und auf einheitlicher Basis erstellt sein.	It would be difficult to support a subsidy scheme that channelled most of the aid to the large farms in the best agricultural regions.
In dem Bericht wird ganz richtig die gesetzliche Grundlage statistischer Angaben, insbesondere in Änderungsantrag 2 und in Änderungsantrag 3 zur Präzisierung des Anteils der Vorauszahlungen der Gemeinschaft erläutert.	We have no data on this, but have to be content with the rumours that 80% of aid would go to 20% of farmers.
Die politisch wichtigste Botschaft ist in den Änderungsanträgen 4 und 5 enthalten, wonach die erhaltenen Beihilfen zum Beispiel entsprechend der Fläche der landwirtschaftlichen Betriebe zu klassifizieren sind.	Amendment No 1 emphasised the importance of statistics in connection with enlargement towards the east.
Diese Angabe ist sehr wichtig, wenn man an den sozialen Aspekt der Agrarbeihilfen denkt.	This is a very important consideration that still means much work for the EU and the applicant countries.
Es wäre auch problematisch, ein Beihilfesystem zu befürworten, das die meisten Beihilfen in die großen Betriebe in den besten landwirtschaftlichen Gebieten lenkt.	The problems over statistics for the applicant countries will not be resolved through this report.
Wir verfügen hierzu über keine verbrieften Angaben, sondern müssen uns mit den Gerüchten begnügen, wonach achtzig Prozent der Beihilfen an zwanzig Prozent der Bauern gehen würden.	Problems have continued since the land register began to function.
In Änderungsantrag 1 wird die Bedeutung der Statistiken im Zusammenhang mit der Osterweiterung hervorgehoben.	Embarking on eastward enlargement without any information on its effect on the budget would be political suicide.
Dabei handelt es sich um einen besonders wichtigen Aspekt, der sowohl von der EU als auch den Kandidatenländern noch viel Arbeit erfordert.	It does not help much, though, if our current data on expenditure is based on mistaken or unreliable data.
Die Statistikprobleme der Kandidatenländer werden durch diesen Bericht nicht gelöst.	The most important aspect of statistical data on the European farmer is the reference yield.
Es gibt nach wie vor genug Probleme.	When Finland became a Member, as a result of poor yield in previous years, we had to be satisfied with a figure that did not reflect the truth in normal years.
Die fangen schon bei einem funktionierenden Grundbuch an.	These reference yields should be raised to a realistic level as soon as possible, or we should start to reconsider the whole basis of their use and the idea of a drop in the price of grain as compensation for hectarage aid.
Der Beginn der Osterweiterung ohne Angaben über ihre Auswirkungen auf den Haushalt wäre politischer Selbstmord.	We cannot undertake to subsidise producers in regions of highest yield in Europe for years and years on account of price reductions that have sometimes taken place in the past.
Dennoch hilft das nicht viel, wenn sich unsere jetzigen Informationen über die Ausgaben auf falsche und unzuverlässige Angaben gründen.	The most obvious answer would be to harmonise hectarage aid as closely as possible within the whole territory of the EU.
Die für den europäischen Bauern bedeutsamste statistische Angabe ist die Kennziffer Ernte.	Mr President, the ELDR group supports this report.
Als Finnland Mitglied der EU wurde, mußten wir uns aufgrund der schlechten Ernten der Vorjahre mit einem Niveau zufriedengeben, das nicht dem der normalen Jahre entspricht.	Mr President, rapporteur, everyone here agrees that we should highlight the need to have statistics for agriculture, at a Community level, that are as precise, as reliable and as coherent as possible, so that we can effectively assess the consequences of decisions taken under the CAP, particularly on rural areas.
Diese Kennziffern müßten vielmehr auf ein reales Niveau angehoben werden oder man hätte beginnen müssen, die Grundlage für die gesamte Anwendung des Ernteindex neu und den Begriff der Hektarbeihilfen so zu definieren, daß er den Fall des Getreidepreises kompensiert.	European agriculture is not uniform.
Wir können uns nicht für Jahrzehnte verpflichten, aufgrund von in der Vergangenheit erfolgten Preissenkungen die Erzeuger in den besten Getreidegebieten Europas zu stützen.	On the contrary, it is extremely diverse.
Am übersichtlichsten wäre es, die Hektarbeihilfen im gesamten Gebiet der EU zu vereinheitlichen.	It is therefore essential that statistics are accurate enough in terms of land, and compiled in a harmonised way, for us to be able to obtain judicious analyses by production type and by ecosystem.
Herr Präsident, die Fraktion der ELDR unterstützt diesen Bericht.	In 1996, the European Parliament adopted a report by Mr Jové Perez whose proposals aimed to make European statistics much more accurate and reliable.
Herr Präsident, Frau Berichterstatterin, werte Kolleginnen und Kollegen, alle sind sich hier darüber einig, daß wir auf Gemeinschaftsebene eine möglichst präzise, zuverlässige und kohärente Agrarstatistik brauchen, um die Auswirkungen der im Rahmen der GAP gefaßten Beschlüsse, insbesondere auf den ländlichen Raum, wirksam messen zu können.	Unfortunately, the Commission' s rather unambitious proposal that has been submitted to us has taken no account of it.
Die europäische Landwirtschaft ist keineswegs einheitlich, sondern im Gegenteil äußerst vielfältig.	This is why we shall support all of the amendments put forward by the Committee on Agriculture and Rural Development as well as the one by Mr Jové Perez.
Deshalb kommt es wesentlich darauf an, daß die Statistik auf territorialer Ebene auf harmonisierter Grundlage hinreichend gegliedert ist, um uns sachdienliche Analysen nach Erzeugungsart und nach Ökosystem zu ermöglichen.	Indeed, it seems essential to us that the wealth of information stemming from the implementation of the CAP aid should be made use of as a source of statistics.
Bereits 1996 hatte das Europäische Parlament einen Bericht unseres Kollegen Jové Perez angenommen, der darauf abzielte, die europäische Statistik sehr viel präziser und effizienter zu gestalten.	The cost to the Community budget would be almost nothing and statistical secrecy would be guaranteed through the data being incorporated.
Leider trägt der uns vorliegende wenig ambitionierte Vorschlag der Kommission dem in keiner Weise Rechnung.	This is the concern that led our group to table an amendment yesterday concerning the traceability of beef and veal because, as a result of the CAP aid, all animals in the European herd must be identified.
Aus diesem Grunde unterstützen wir sämtliche vom Ausschuß für Landwirtschaft und ländliche Entwicklung vorgelegten Änderungsvorschläge sowie den Vorschlag unseres Kollegen Jové Perez.	This applies to abattoirs, too, for reasons of food and animal safety.
Wir sehen es in der Tat als wesentlich an, daß der Datenfundus, der bei der Umsetzung der GAP­Beihilfen entsteht, als statistische Quelle genutzt wird.	I have not yet understood why the Commission has not accepted that, as of 1 January, these two facts, which have already been made compulsory across the Community, should be used to enable the operational start of traceability.
Daraus würden für den Gemeinschaftshaushalt fast keine Kosten erwachsen, und das statistische Geheimnis bliebe dank der Datenaggregation gewahrt.	It is quite inconsistent to postpone the establishment of compulsory labelling of beef and veal for another year and, at the same time, to condemn France' s application of the precautionary principle, precisely because there is no such compulsory labelling.
Aus dem gleichen Anliegen heraus hat unsere Fraktion gestern einen Änderungsantrag im Rahmen der Rückverfolgbarkeit des Rindfleischs eingebracht, denn zu Zwecken der GAP­Beihilfen werden sämtliche Tiere des gemeinschaftlichen Viehbestandes obligatorisch erfaßt.	If the free movement of products is not accompanied by rigorous labelling, consumers will think it is a confidence trick.
Das gleiche gilt auch für die Schlachthöfe aus gesundheitlichen und tiergesundheitlichen Gründen.	It is regrettable that Commissioner Byrne does not employ his zeal in the service of the health and the interest of European consumers.
Ich habe immer noch nicht begriffen, warum die Kommission nicht damit einverstanden war, daß diese beiden Daten, die ja auf Gemeinschaftsebene bereits zwingend vorgeschrieben sind, ab 1. Januar nächsten Jahres gleichzeitig verwendet werden, um mit der Rückverfolgbarkeit zu beginnen.	Mr President, I too was under the impression that I would be talking about the regulation on hops but, since the issue of statistics has arisen, I feel it is my duty to address it.
Es macht überhaupt keinen Sinn, die Einführung der obligatorischen Kennzeichnung von Rindfleisch noch um ein weiteres Jahr zu verschieben und gleichzeitig Frankreich dafür zu verurteilen, daß es eben aufgrund des Fehlens der obligatorischen Kennzeichnung das Vorsorgeprinzip anwendet.	As we all know, statistics often have different interpretations which can mean just what we want them to mean.
Der freie Güterverkehr gerät, wenn er nicht mit einer konsequenten Etikettierung einhergeht, für den Verbraucher zu einem Täuschungsmanöver.	If this is the case, then inconsistent statistics will only exacerbate the problem.
Es ist bedauerlich, daß Kommissionsmitglied Byrne sich nicht stärker für die Gesundheit und die Interessen der europäischen Verbraucher engagiert.	This is why I also agree that statistics on the movement, policies and trade of agricultural products must be as consistent as possible.
Herr Präsident, eigentlich wollte ich erst bei der Verordnung über Hopfen das Wort ergreifen, aber jetzt geht es um die Statistik, und da muß ich meine Pflicht erfüllen.	It would be ideal if each State did not, statistically at least, paint a different picture of our agricultural economy.
Statistiken können bekanntlich insofern unterschiedlich ausgelegt werden, als das belegt werden soll, was derjenige, der sie auswertet, nachweisen möchte.	Then, despite any diverse interpretations, we would at least have one true common version of the facts which would help those wishing to examine in closer detail what those statistics actually represent.
Wenn dies zutrifft und wir andererseits nicht einmal über einheitliche Statistiken verfügen, dann potenziert sich das Problem.	I agree, therefore, that we should adopt the regulation, and I also agree with the comments on the amendments which have been made so that the Commission can see to it that the statistics paint as uniform and reliable a picture as possible.
Deshalb sollten wir auch meiner Meinung nach die Statistiken, die den Warenverkehr, die Politik und den Handel mit unseren Agrarerzeugnissen betreffen, weitgehend einheitlich gestalten, und es wäre zu begrüßen, wenn zumindest bei den Statistiken nicht jeder Staat über eine eigene Darstellung der Fakten in bezug auf unsere Landwirtschaft verfügte.	Mr President, technical action plans were established for statistics in 1996, 1997, 1998 and 1999.
Ließe sich dies erreichen, dann hätten wir, selbst bei unterschiedlichen Interpretationen, zumindest eine einheitliche Darstellung, was denjenigen entgegenkäme, die das, was sich hinter den Statistiken verbirgt, richtig deuten wollen.	This is a sign of foresight, but it also shows that developments have been so rapid in recent years that standing still really means going backwards.
Folglich bin ich damit einverstanden, daß wir dieser Verordnung zustimmen, schließe mich aber auch den Bemerkungen in den vorgelegten Änderungsanträgen an, damit so die Kommission selbst dafür Sorge trägt, daß die statistische Aufbereitung so einheitlich und zuverlässig wie möglich erfolgt.	This area can justly be described by the phrase 'never finished, always on the way' .
Herr Präsident, für die Statistik 1996, 1997, 1998 und 1999 sind technische Aktionspläne entwickelt worden.	The European Union ought, as quickly as possible, to be in possession of common statistical material which is comprehensive in all areas.
Das deutet auf Weitblick hin, zeigt aber auch, daß die Entwicklung in diesen Jahren so schnell vor sich geht, daß Stillstand in Wirklichkeit Rückschritt ist.	The Commission says that the Community' s agricultural statistics should continue to be adapted in the years 2000-2002.
Dieser Bereich kann zu Recht mit den Worten beschrieben werden: "Niemals fertig, immer unterwegs ".	This means that we are talking here about extending these.
Die Union braucht so schnell wie möglich gemeinsames statistisches Material, das alle Bereiche abdeckt.	If for a moment we look back to 1957 when the Treaty of Rome came into being, it was in fact the agricultural sphere which was the first big area upon which agreement was reached.
Die Kommission spricht davon, daß die Anpassung des statistischen Materials für die Landwirtschaft der Gemeinschaft in den Jahren 2000-2002 fortgeführt werden soll.	Today - nearly 43 years later - no completely satisfactory statistics have been established for this area.
Es handelt sich also um eine Verlängerung.	The debate this week about the registration of animals showed very clearly that 12 out of 15 countries had not even begun preparations for this work.
Erinnern wir uns einen Moment an die Entstehung des Vertrags von Rom im Jahre 1957: Die Landwirtschaft war der erste große Bereich, über den Vereinbarungen getroffen wurden.	Things are naturally interconnected.
Heute - fast 43 Jahre danach - gibt es noch immer keine vollständige, ausreichende Statistik auf diesem Gebiet.	Without registration, careful statistics cannot be kept and there are therefore, of course, opportunities for a series of errors regarding payments.
Die Debatte in dieser Woche über die Registrierung von Vieh hat mit aller Deutlichkeit gezeigt, daß 12 von 15 Ländern noch nicht einmal mit der Vorbereitung dieser Arbeit begonnen haben.	The Community makes contributions to offset the Member States' expenditure in connection with implementing the relevant arrangements.
Es gibt natürlich einen Zusammenhang.	It is therefore necessary that the Commission should now do some tightening up.
Ohne Registrierung kann keine genaue Statistik erstellt werden.	It cannot be the slowest countries which are to set the pace.
Deshalb sind natürlich Fehler in bezug auf die Auszahlungen möglich.	The Commission ought to set the agenda to a much greater degree and lead the Member States in accordance with the common resolutions.
Die Gemeinschaft leistet einen Beitrag zu den Ausgaben der Mitgliedstaaten bei der Umsetzung der Maßnahmen.	How can we envisage re-establishing consumer confidence in food following all the scandals when the EU cannot even implement its own resolutions?
Deshalb ist es erforderlich, daß die Kommission jetzt entschiedener handelt.	Food safety, risk assessment and the very concept of safety are such important areas that there is no avoiding them nowadays.
Das Tempo darf nicht von den langsamsten Ländern vorgegeben werden.	Allow me, therefore, quietly to ask: when are we to put our own house in order?
Die Kommission sollte die Tagesordnung in stärkerem Maße selbst festlegen und die Mitgliedsländer entsprechend den gemeinsamen Beschlüssen führen.	Finally, ladies and gentlemen, there is no reason to hesitate.
Wie will man nach den vielen Skandalen das Vertrauen der Verbraucher in die Lebensmittel wiedergewinnen, wenn die EU nicht einmal ihre eigenen Beschlüsse umsetzen kann?	The future belongs to those who prepare themselves for it.
Die Sicherheit der Lebensmittel, die Einschätzung des Risikos und auch der Sicherheitsbegriff selbst sind so wichtige Bereiche, daß man heute nicht umhin kann, diese Probleme anzusprechen.	Mr President, a little while ago another speaker again brought up the fact that the compulsory labelling system for beef is not to be introduced until 1.1.2001.
Ich möchte deshalb in aller Bescheidenheit fragen: Wann werden wir in unserem eigenen Haus Ordnung schaffen?	I am able to inform you that the Council has obviously adopted our demand to introduce this system by 1.9.
Zum Schluß, werte Kollegen: Wir dürfen nicht zaudern.	This represents a small victory for the European Parliament as far as the timeframe is concerned.
Die Zukunft gehört dem, der sich auf sie vorbereitet.	However, it did not reach this decision under the codecision procedure.
Herr Präsident, es wurde vorhin von einem Kollegen noch einmal gesagt, daß das obligatorische System der Kennzeichnung von Rindfleisch erst zum 1.1.2001 eingeführt werden soll.	This would have meant it also having to adopt all the other proposed amendments that we voted on here yesterday in the simplified procedure.
Ich kann Ihnen mitteilen, daß der Rat offensichtlich unsere Forderung, dies zum 1.9. einzuführen, übernommen hat.	Then all our proposed amendments would have been adopted in the codecision procedure.
Dies bedeutet einen kleinen Sieg für das Europäische Parlament, was die Zeit anbelangt.	Instead of which, the Council decided, under the old regulation 820/97, in accordance with Article 19 of the implementing rules, that the Member States now have the facility to continue with the voluntary system until 1.9.2000.
Er hat diesen Beschluß aber nicht im Rahmen des Mitentscheidungsverfahrens gefaßt.	I do not consider this to be the right strategy either.
Das hätte bedeutet, daß er alle anderen Anträge, über die wir gestern hier abgestimmt haben, auch im vereinfachten Verfahren hätte übernehmen müssen.	It does, however, go some way towards meeting European Parliament requirements.
Dann wäre im Mitentscheidungsverfahren alles von uns übernommen worden.	Apart from that, we are now going to continue with the codecision procedure for the other proposed amendments, which we voted on yesterday, for this process will run on after 1.1.2000.
Statt dessen hat er im Rahmen der alten Verordnung 820/97 gemäß Artikel 19 der Durchführungsbestimmungen entschieden, daß jetzt bis zum 1.9.2000 die Staaten die Möglichkeit haben, das freiwillige System weiterzuführen.	The Council must give its reaction to this.
Ich halte auch dies nicht für rechtens.	If it fails to adopt our proposed amendments then we will become involved in a conciliation procedure.
Es ist aber in der Sache ein Zugehen auf das Europäische Parlament.	All the other matters that we want to include in this regulation will therefore still be a matter for debate.
Ansonsten befinden wir uns jetzt mit den anderen Änderungsanträgen, über die wir gestern abgestimmt haben, weiter in dem Mitentscheidungsverfahren, denn das läuft jetzt über den 1.1.2000 hinaus.	I hope that we will be able to persuade the Council to adopt our proposals in this area too, and that it allows reason to prevail.
Der Rat muß darauf reagieren.	Mr President, following the entry into force of the Amsterdam Treaty the proposals concerning statistics, including agricultural statistics, are based on Article 285.
Wir werden, wenn er unsere Änderungsanträge nicht übernimmt, uns dann in einem Konzertierungsverfahren befinden.	It foresees adoption according to the codecision procedure.
Die ganzen anderen Angelegenheiten, die wir noch in diese Verordnung einbeziehen wollen, sind dann also noch in der Auseinandersetzung.	The proposal submitted today for your approval is the first example insofar as agricultural statistics are concerned.
Ich hoffe, daß wir auch da gegenüber dem Rat unsere Vorstellungen durchsetzen können, und daß der Rat auch hier Vernunft walten läßt.	I should like to thank the rapporteur, Mrs Redondo Jiménez, for her excellent work and, in particular, for her cooperation with the Council and the Commission on this dossier.
Seit Inkrafttreten des Vertrags von Amsterdam haben die Vorschläge zu Statistiken, darunter die Agrarstatistik, den Artikel 285 zur Grundlage.	The Commission is very pleased about the global support expressed in the report for the draft Council and Parliament decision.
Darin ist die Annahme mittels Mitentscheidungsverfahren vorgesehen.	The background is Council Decision 96/411(EC) on improving Community agricultural statistics.
Der heute unterbreitete Vorschlag, der von Ihnen angenommen werden soll, ist das erste Beispiel, in dem es um Agrarstatistik geht.	It has put at the Commission's disposal a flexible tool which allows it to adapt statistical applications to changes in information needs.
Ich möchte der Berichterstatterin, Frau Redondo Jiménez, für ihre ausgezeichnete Arbeit und speziell für ihre Zusammenarbeit mit dem Rat und der Kommission zu dieser Thematik danken.	This has helped to adapt the system of Community agricultural statistics to changes in the common agricultural policy.
Die Kommission ist sehr erfreut über die im Bericht über den Vorschlag für eine Entscheidung des Rates und des Parlaments geäußerte allseitige Unterstützung.	In its report to the European Parliament and the Council the Commission has presented an overview of the actions undertaken during the period 1996-1999 in different areas.
Hintergrund ist die Entscheidung des Rates 96/411/EG zur Verbesserung der Agrarstatistik der Gemeinschaft.	The overall assessment of these actions by the Commission is positive.
Damit wurde der Kommission ein flexibles Instrument an die Hand gegeben, mit dessen Hilfe statistische Anwendungen an veränderte Informationsbedürfnisse angepaßt werden können.	However, the process of adapting national statistical systems to the needs arising from the reform of the common agricultural policy has not yet been completed.
Die Anpassung des Systems der Agrarstatistik der Gemeinschaft an die veränderte Gemeinsame Agrarpolitik ist dadurch erleichtert worden.	The Commission has therefore proposed to extend for a further three years, with some minor changes, the validity of Decision 96/411(EC).
In ihrem Bericht an das Europäische Parlament und den Rat gab die Kommission eine Übersicht über die Aktionen, die im Zeitraum 1996-1999 in verschiedenen Bereichen durchgeführt wurden.	The changes are mainly aimed at either simplifying the implementation of this action programme or at reducing the delay for paying the Community contribution.
Diese Aktionen werden von der Kommission insgesamt positiv bewertet.	It is important to ensure that this new decision enters into force as soon as possible in order to avoid a vacuum in the present legislation.
Allerdings ist der Anpassungsprozeß der nationalen Statistiksysteme an die aus der Reform der Gemeinsamen Agrarpolitik resultierenden Erfordernisse noch nicht ganz abgeschlossen.	An effort should be made to adopt this proposal after first reading.
Aus diesem Grunde hat die Kommission vorgeschlagen, die Gültigkeit der Entscheidung 96/411/EG mit einigen unwesentlichen Änderungen um weitere drei Jahre zu verlängern.	As concerns Mrs Redondo Jiménez's report, the Commission can accept Amendments Nos 1, 2 and 3.
Die Änderungen zielen hauptsächlich entweder auf die Vereinfachung der Durchführung dieses Aktionsprogramms oder auf die Verkürzung der Zahlungsfrist für den Gemeinschaftsbeitrag ab.	The Commission cannot, however, accept Amendment No 4, even in its new, modified version.
Diese neue Entscheidung sollte unbedingt so schnell wie möglich in Kraft treten, um ein Vakuum in den derzeitigen Rechtsvorschriften zu vermeiden.	This amendment would still imply some new obligations for Member States which have not yet been discussed in the Council.
Wir sollten darauf hinarbeiten, diesen Vorschlag nach erster Lesung anzunehmen.	This would certainly prevent the adoption of the proposal in the Council at first reading.
Was den Bericht von Frau Redondo Jiménez betrifft, so kann die Kommission die Änderungsanträge 1, 2 und 3 akzeptieren.	Nevertheless, the Commission agrees with the rapporteur that the additional information requested by this amendment would indeed be useful in order to have a better idea of the distribution of aid paid in the context of the common agricultural policy.
Allerdings kann sie Änderungsantrag 4, auch in seiner neuen, verbesserten Fassung, nicht annehmen.	The Commission will therefore commit itself to include such actions in the next technical programmes, starting from 2001, in view of encouraging progress in this area.
Dieser Änderungsantrag würde einige neue Verpflichtungen für die Mitgliedstaaten beinhalten, die im Rat noch nicht erörtert worden sind.	We hope that this may reassure the European Parliament about our intentions and may lead Mrs Redondo Jiménez to withdraw this amendment in order to allow the proposal to be adopted at first reading.
Dadurch würde die Annahme des Vorschlags im Rat in erster Lesung sicherlich verhindert werden.	- (ES) Mr President, I have to point out to the Commission that it is not an amendment by the rapporteur, but an amendment by the Committee on Agriculture and, therefore, it is voted on in committee and, in accordance with the Rules of Procedure, it cannot be withdrawn.
Nichtsdestotrotz stimmt die Kommission mit dem Berichterstatter darin überein, daß die in diesem Änderungsantrag geforderten zusätzlichen Informationen in der Tat von Nutzen wären, um einen besseren Überblick über die gezahlten Beihilfen im Zusammenhang mit der Gemeinsamen Agrarpolitik zu erlangen.	Also, Amendment No 5, which would cause No 4 to lapse - which is the one that I hope the Commission will accept - only affects the Commission, not the Council.
Die Kommission verpflichtet sich daher, solche Aktionen in den kommenden technischen Programmen, die im Jahre 2001 beginnen, zu berücksichtigen, um Fortschritte in diesen Bereichen zu erzielen.	Its content is already regulated by the new Regulation 2390/99, which will be coming into force.
Wir hoffen, daß das Europäische Parlament dadurch sieht, was wir vorhaben, und daß Frau Redondo Jiménez ihren Änderungsantrag zurückzieht, damit der Vorschlag in erster Lesung angenommen werden kann.	Furthermore, the amendment does not include any additional obligation for the Commission.
.	Therefore, I hope that the Commission will accept it, because we have provided all the means for this proposal to be approved at first reading.
(ES) Herr Präsident!	Mr President, just a short comment on Amendment No 5.
Ich muß der Kommission erläutern, daß es sich nicht um einen Änderungsantrag der Berichterstatterin sondern des Landwirtschaftsausschusses handelt, und deshalb wurde über ihn im Ausschuß abgestimmt und kann nach der Geschäftsordnung nicht zurückgezogen werden.	Unfortunately, we are not able to accept Amendment No 5 because we know that the Council would not accept it.
Änderungsantrag 5, durch den die Nummer 4 hinfällig würde - von dem ich hoffe, daß er von der Kommission akzeptiert wird -, betrifft nur die Kommission, nicht den Rat.	The debate is closed.
Sein Inhalt ist bereits durch die neue Verordnung 2390/99, die in Kraft treten wird, geregelt.	We shall now proceed to the vote.
Der Änderungsantrag schließt darüber hinaus keine zusätzliche Verpflichtung für die Kommission ein.	(Parliament approved the legislative resolution) EXPLANATION OF VOTE
Daher erwarte ich, daß die Kommission ihn akzeptiert, denn wir haben alles darangesetzt, damit dieser Vorschlag in erster Lesung gebilligt wird.	Mr President, as the applause for the rapporteur, Mrs Redondo Jiménez, confirmed, this is one of the most important measures we have voted on.
Herr Präsident, lediglich eine kurze Einlassung zum Änderungsantrag 5. Wir sehen uns leider außerstande, Änderungsantrag 5 anzunehmen, da wir wissen, daß der Rat ihn nicht genehmigen wird.	Indeed, in my opinion, statistics are fundamental and in Italy we are in the most terrible chaos as regards the statistics on milk from our cows.
Die Aussprache ist geschlossen.	Therefore, I voted for the report and I would like to express the hope that statistics will also be gathered on the number of pensioners in the fifteen Member States.
Wir kommen nun zur Abstimmung.	Many people say there are too many of them, but I say there are too few: statistics will allow us to ascertain their number.
(Das Parlament nimmt die legislative Entschließung an.)	For my part, I would like there to be more and more of them, because 'it is great being a pensioner' .
Erklärung zur Abstimmung	COM in hops
Herr Präsident, wie der Beifall für die Berichterstatterin Redondo Jiménez bestätigt hat, ist dies eine der wichtigsten Maßnahmen, über die wir abgestimmt haben.	The next item is the debate on the report (A5-0083/1999) by Mr Xaver Mayer, on behalf of the Committee on Agriculture and Rural Development, on the proposal for a Council regulation (EC) amending Regulation (EEC) 1696/71 on the common organisation of the market in hops [COM(1999) 302 - C5­0081/1999 - 1999/0128(CNS)].
Statistiken sind meines Erachtens wirklich von entscheidender Wichtigkeit, und in Italien herrscht, was die Statistik über die Milchproduktion unserer Kühe betrifft, ein absolutes Chaos.	Mr President, Commissioner, five minutes are enough for a Friday.
Deshalb habe ich für den Bericht gestimmt und möchte der Hoffnung Ausdruck verleihen, daß auch Statistiken über die Zahl der Rentner in den fünfzehn Mitgliedstaaten erstellt werden.	I had actually anticipated having less time, which means that I can make a few additional comments and still keep to my time.
Viele erklären, es gäbe zu viele Rentner, ich sage, es sind wenig: Mit Hilfe der Statistik werden wir die Frage klären können.	Hops are a special kind of plant.
Ich für meinen Teil wünschte, die Rentner würden immer zahlreicher, denn "das Rentnerdasein ist schön ".	After all, they add flavour and wort to this important popular foodstuff we call beer.
GMO für Hopfen	(Applause)
Nach der Tagesordnung folgt die Aussprache über den Bericht (A5-0083/1999) von Herrn Xaver Mayer im Namen des Ausschusses für Landwirtschaft und ländliche Entwicklung über den Vorschlag für eine Verordnung (EG) des Rates zur Änderung der Verordnung (EWG) 1696/71 über die gemeinsame Marktorganisation für Hopfen (KOM(1999) 302 - C5­0081/1999 - 1999/0128(CNS))	Truth is to be found not just in wine but also in beer.
Herr Präsident, Frau Kommissarin!	This is particularly important in the case of Bavaria, the land I come from and where this foodstuff we call beer has had an important role to play, both in terms of development down through the ages and the population' s outlook.
Fünf Minuten für Freitag sind genug.	Weißbier is, of course, a special kind of beer; it is well known in Munich and many people enjoy the taste.
Eigentlich habe ich mich auf weniger Zeit eingestellt, aber dann kann ich noch einige zusätzliche Anmerkungen machen und werde trotzdem nicht überziehen.	It is true that hops would grow almost anywhere but it takes people with special qualities to give the hops the care they need, so as to ensure a successful crop.
Hopfen ist eine besondere Pflanze.	There are a number of sayings about this, such as Der Hopf ist ein Tropf (hops are little rascals), which may prove rather difficult to translate but literally means: hops are a fickle crop that rewards careful tending particularly well but also makes one pay for sloppy work.
Er bringt letztendlich Geschmack und Würze in dieses wichtige Volksnahrungsmittel Bier.	Hops also expect a daily visit from the master.
(Beifall)	What all this amounts to is that hops are a very labour-intensive crop and therefore tend to be more widespread amongst people of an industrious bent.
Nicht nur im Wein liegt die Wahrheit, auch im Bier.	That explains why a large hop cultivation area has grown up where I come from.
Das ist gerade für Bayern besonders wichtig, das Land, aus dem ich komme und in dem dieses Produkt Bier, dieses Nahrungsmittel Bier in der historischen Entwicklung, wie aber auch in der Einstellung der Bevölkerung eine große Rolle gespielt hat.	In central Bavaria, the Hallertau, a large hop cultivation area - in fact the largest in the world, because approximately one quarter of production derives from the Hallertau - has been developing over the last 150 years or more.
Weißbier ist natürlich eine besondere Form des Bieres; es ist in München bekannt und schmeckt vielen.	Of course that is why this issue is of particular significance for Bavaria and for myself as a native of Bavaria.
Hopfen würde zwar fast überall wachsen, aber es gehören auch besondere Menschen dazu, um den Hopfen entsprechend zu pflegen, damit der Hopfenanbau erfolgreich ist.	(Applause)
Dazu gibt es auch einige Sprüche: Der Hopf ist ein Tropf, das ist vielleicht etwas schwierig zu übersetzen, soll sagen: Der Hopfen ist eine launische Frucht, die gute Pflege besonders belohnt, aber auch schlampige Arbeit bestraft.	I would like to again emphasise the fact that hops and beer made from hops could be said to stand for sociableness, for relaxation even.
Zum anderen, der Hopfen will täglich seinen Herrn sehen.	Incidentally, hops are also used for medicinal purposes.
Das besagt, daß Hopfen eine sehr arbeitsintensive Frucht ist und sich deshalb bei den fleißigen Menschen mehr verbreitet.	Bavaria is primarily famous for being the land of beer, but also for being the land of tradition and progress.
So ist bei uns ein größeres Anbaugebiet entstanden.	You are bound to have often heard it said that tradition and progress are rated particularly highly in Bavaria.
In der Mitte von Bayern, in der Hallertau, hat sich seit mehr als 150 Jahren ein großes Hopfenanbaugebiet entwickelt, das größte in der gesamten Welt, denn ungefähr ein Viertel der Produktion stammt aus der Hallertau.	Indeed, the lederhosen and laptop saying is often quoted by Bavaria' s leader Mr Stoiber.
Deshalb ist dieses Thema für Bayern und für mich als Bayer natürlich auch wichtig.	Bavaria is not just famous for the Oktoberfest in Munich but also for its high tech.
(Beifall)	It is not without reason that the world famous University of Brewing of Munich-Weihenstephan is located in Bavaria.
Ich möchte noch einmal unterstreichen, Hopfen und Bier aus Hopfen steht ja irgendwo für Gemütlichkeit, sogar für Beruhigung.	It has disseminated a great deal of knowledge to the world and has heavily influenced both hop cultivation and beer production in the far-flung corners of China and Russia, and even in the USA.
Hopfen wird übrigens auch als Medizin eingesetzt.	Hence another saying: Hopfen und Malz, Gott erhalt' s (hops and malt, may God preserve them).
Bayern ist besonders bekannt als Land des Bieres, aber auch als Land von Tradition und Fortschritt.	This is important, also with regard to the regulation put forward by the Commission.
Sie haben sicherlich schon oft gehört, daß Tradition und Fortschritt in Bayern als besonders wichtig angesehen werden.	I had a few other comments I wanted to make but I must keep within my time.
Der Spruch von Lederhose und Laptop wird ja auch von Ministerpräsident Stoiber häufig verwendet.	I now come to the regulation and the report.
Der Standort Bayern ist nicht nur für das Oktoberfest in München, sondern auch für High Tech bekannt.	It all boils down to the fact that many provisions in this area can no longer be used owing to their no longer being valid or due to the implications of the common organisation of the markets for hops.
Nicht umsonst steht auch die weltbekannte Brauuniversität München-Weihenstephan eben in Bayern.	What it amounts to is that there is no longer a requirement to draft a major report annually, rather, owing to the fact that grants have been established for a period of five years, a report only has to be submitted once every five years from now on.
Von dieser Stätte aus gingen viele Erkenntnisse in die Welt und haben den Hopfenanbau ebenso wie die Herstellung des Bieres bis nach China, Rußland oder auch bis in die USA sehr stark beeinflußt.	Commissioner, I consider this plan to be right-minded, but with one minor reservation.
Deshalb gibt es dort auch den Spruch "Hopfen und Malz, Gott erhalt's ".	It is only right, in view of the vast experience we have accumulated in Bavaria, that we should also pay a little more attention to the situation there, hence my suggestion that we must ensure that, as is already the case, the annual collection of data relating to the development of the areas under cultivation, demand, the spread of different types, prices, and also cultivation development, proceeds uninterrupted in the individual Member States, and that this information is made available to all concerned on an annual basis.
Das ist wichtig, auch für diese von der Kommission vorgeschlagene Verordnung.	I have obtained the Commission' s consent for this to be done over the Internet.
Ich hätte noch ein paar Anmerkungen, aber ich muß mich an die Zeit halten.	This is why I have put forward two amendments and I call upon Parliament to vote in favour of them.
Ich komme nun zu der Verordnung und zu dem Bericht.	I know, however, that the Commission does not look very kindly upon these proposed amendments.
Es geht im wesentlichen darum, daß hier manche Regelungen aufgrund abgelaufener Geltungsdauer oder auch des Inhalts der gemeinsamen Marktorganisation für Hopfen nicht mehr anwendbar sind.	However, Parliament is something of a different kettle of fish to the Commission in my view.
Es kommt dazu, daß nicht mehr jährlich ein großer Bericht erstellt werden muß, sondern wegen der Festlegung der Beihilfe auf fünf Jahre muß nur mehr alle fünf Jahre ein Bericht vorgelegt werden.	That is why I am asking for your support.
Dieses Vorhaben, Frau Kommissarin, sehe ich als richtig an, aber mit einer kleinen Einschränkung.	(Laughter, applause)
Aufgrund unserer großen Erfahrung in Bayern müssen wir hier auch etwas besser aufpassen.	Mr Mayer, I trust that after the sitting you will offer us a tasting.
So schlage ich vor, daß sichergestellt werden muß, daß wie bisher die jährliche Erfassung von Daten bezüglich der Entwicklung der Anbauflächen, der Nachfrage, der Verbreitung der verschiedenen Sorten, der Preise sowie der Anbauentwicklung in den einzelnen Mitgliedsländern vorgenommen wird und daß diese Angaben den Beteiligten jährlich zur Verfügung gestellt werden.	Mr President, I sent an invite for a beer-tasting session about three weeks ago and it was very much to the taste of all those that received and took up the invitation.
Ich habe die Zusage von der Kommission, daß dies über das Internet geschehen soll.	I have no doubt, Mr Mayer.
Deshalb habe ich zwei Änderungsanträge gestellt.	Mr President, I simply wish to thank and congratulate Mr Mayer on the report he has carried out, which affects all the hop-producing countries of the Community and which, in the case of Spain, affects my region, Castilla-León, in the León area.
Ich bitte das Parlament, denen zuzustimmen.	I agree with everything Mr Mayer has said.
Ich weiß aber auch, daß die Kommission diese Änderungsanträge nicht so gern sieht.	The report has been unanimously approved in the Committee on Agriculture.
Aber ich meine, das Parlament ist ein bißchen etwas anderes als die Kommission.	I congratulate Mr Mayer and I hope that he receives the support of this Parliament.
Deshalb bitte ich um die Zustimmung.	Mr President, Mr Mayer was so charming that I would like to extend the offer by suggesting that we have that beer in Bavaria itself, not here.
(Heiterkeit, Beifall)	I shall now come to the point.
Herr Mayer, ich vertraue darauf, daß Sie uns nach der Sitzung eine Verkostung anbieten werden.	Hops are not a typical enough example for us to understand the importance of the common agricultural policy for farmers in the European Union.
Herr Präsident, ich habe schon vor etwa drei Wochen zu einer Bierprobe eingeladen, und es hat all denen, die diese Mitteilung bekommen und teilgenommen haben, sehr geschmeckt.	They do, however, show the extent to which it actually helps our farmers.
Daran zweifle ich nicht, Herr Mayer.	As Mr Mayer said, hops are a traditional product which is particularly important to the quality of beer produced, although production is very limited; some 4 000 hectares of land throughout the whole of Europe.
Herr Präsident!	Yet a sufficient number of farming families in the countries where hops are produced, particularly in Bavaria, make their living from that product alone.
Ich möchte Herrn Mayer einfach nur danken und ihn zu seinem Bericht beglückwünschen, der alle Hopfenerzeugerländer in dieser Gemeinschaft und im Fall von Spanien meine Region, Kastilien und León, im Gebiet León angeht.	These families should not be left to the mercy of continual price falls, neither should they be forced to desert specific rural areas because of difficulties arising from irregularities within the market.
Ich stimme Herrn Mayer in allem zu.	There have been a number of changes to the main regulation relating to this particular product as a result of the market fluctuations and the changing needs of farmers, the most recent being the Council decision to set a uniform level of aid to producers for a period of five years.
Der Bericht ist im Landwirtschaftsausschuß einstimmig angenommen worden.	This latest decision alters the obligations of the Commission arising from the previous regime, that is of having to grant annual aid, and Members States no longer need to grant aid for setting up production teams.
Ich gratuliere Herrn Mayer und hoffe, daß er die Unterstützung des Plenums erhält.	This development means that certain articles of the old regulation need to be revoked which, rightly so, is carried out in the new regulation for which we will be voting, together with Mr Mayer' s amendments, noting that the proposed regulation will not in any way affect the budget.
Herr Präsident!	Mr President, I should like to congratulate the rapporteur on the report.
Herrn Mayers Ausführungen waren so erfrischend, daß ich Ihren Vorschlag noch erweitern und anregen möchte, dieses Bier direkt in Bayern und nicht hier zu trinken.	I can inform you that the Group of the European Liberal, Democrat and Reform Party will support the report when it is put to the vote.
Und nun zum eigentlichen Thema.	Mr President, ladies and gentlemen, I first of all want to thank the rapporteur, Mr Xaver Mayer, for a valuable report - and perhaps especially for his enthusiastic presentation of the hop paradise of Bavaria - together with the Committee on Agriculture and Rural Development for its constructive attitude.
Hopfen kann natürlich nicht als Paradebeispiel dienen, um die enorme Bedeutung der Gemeinsamen Agrarpolitik für die Landwirte in der Europäischen Union zu würdigen.	I am very pleased that our proposal for changing the way in which the market for hops is organised has met with a positive reception.
Er zeigt jedoch, wie tiefgehend und weitreichend sie zur Unterstützung unserer Landwirte beiträgt.	The Commission' s proposal is, of course, aimed at removing those stipulations which are no longer valid, either because deadlines have run out or because of previous changes to the common regime under which hops are organised.
Hopfen ist, wie Herr Mayer sagte, eine besondere Pflanze, die die Qualität des erzeugten Biers entscheidend beeinflußt, wenngleich die Produktion äußerst begrenzt ist: Die Anbaufläche umfaßt in der gesamten Union etwa 4 000 Hektar.	These changes must be implemented before the basic regulation is consolidated.
Dennoch leben von diesem Produkt in den Erzeugerländern, vor allem in Bayern, etliche Familienbetriebe, die in einer Zeit des stetigen Preisverfalls nicht ihrem Schicksal überlassen bleiben dürfen.	Owing to the fact that the Council has resolved that the level of support is to remain constant for a period of five years, the Commission does not consider that it is necessary to submit a report every year on the situation concerning the production and marketing of hops.
Ebensowenig können wir eine Entvölkerung bestimmter landwirtschaftlicher Gebiete aufgrund temporärer, durch ein gestörtes Funktionieren des Marktes ausgelöster Schwierigkeiten tolerieren.	The Commission therefore considers that Article 11 can be removed.
Angesichts der Marktschwankungen und der Bedürfnisse der Landwirte bei diesem Erzeugnis sind immer wieder Änderungen an der ursprünglichen Verordnung vorgenommen worden, zuletzt durch den Beschluß des Rates, der einen einheitlichen Satz für die Erzeugerbeihilfe für einen Zeitraum von fünf Jahren festsetzt.	According to Article 18 of the proposal, we shall, however, be presenting, by 1 September 2000, a thorough assessment of the situation regarding the production and marketing of hops.
Durch diesen Beschluß ändern sich einerseits die Verpflichtungen der Kommission aus der bisherigen Regelung in bezug auf die jährliche Beihilfe, und andererseits brauchen die Mitgliedstaaten für die Gründung von Erzeugergemeinschaften keine finanzielle Unterstützung mehr zu gewähren.	I am therefore afraid that the European Parliament' s two amendments complicate the text unnecessarily and that the requirement to receive information each year is already covered by the new proposal.
Diese Entwicklung hat die Streichung bestimmter Artikel der alten Verordnung zur Folge, und genau das wird, völlig richtig, durch die neue Verordnung erreicht, der wir ebenso wie den Änderungsanträgen von Herrn Mayer zustimmen mit dem Hinweis, daß dieser Vorschlag für eine Verordnung keinerlei Auswirkungen auf den Haushalt hat.	This information will also be made available on the Internet.
Herr Präsident, ich möchte dem Berichterstatter zu seinem Bericht gratulieren und kann mitteilen, daß die liberale Fraktion bei der Abstimmung für den Bericht stimmen wird.	That is why the Commission cannot adopt these amendments in this situation.
Herr Präsident, sehr geehrte Abgeordnete!	Mr President, firstly, I would be pleased to invite the Commissioner to Kloster Andechs in Bavaria, a place where seven different types of beer are brewed...
Zunächst möchte ich dem Berichterstatter, Herrn Xaver Mayer, für seinen wertvollen Bericht danken - vielleicht auch gerade für die enthusiastische Darstellung des Hopfenparadieses Bayern - sowie dem Ausschuß für Landwirtschaft und ländliche Entwicklung für dessen konstruktive Haltung.	Secondly, I would like to make it known that next ...
Erfreulicherweise ist unser Vorschlag zur Reorganisation des Hopfenmarktes positiv aufgenommen worden.	(The President cut the speaker off)
Der Vorschlag der Kommission zielt darauf ab, die entweder aufgrund abgelaufener Fristen oder aufgrund schon früher vorgenommener Änderungen der Gemeinsamen Marktordnung für Hopfen ungültig gewordenen Bestimmungen zu streichen.	Mr Posselt, this is not a procedural motion.
Diese Änderungen müssen vor der Konsolidierung der Grundverordnung vorgenommen werden.	The debate is closed.
Da der Rat für einen Zeitraum von fünf Jahren eine Pauschalbeihilfe festgelegt hat, ist die Kommission der Auffassung, daß es nicht erforderlich ist, einen jährlichen Bericht über die Erzeugung und Vermarktung von Hopfen vorzulegen.	We shall now proceed to the vote.
Nach Ansicht der Kommission kann daher Artikel 11 gestrichen werden.	(Parliament approved the legislative resolution)
Gemäß Artikel 18 des Vorschlags werden wir jedoch spätestens am 1. September 2000 eine sorgfältige Auswertung der Erzeugung und Vermarktung von Hopfen vorstellen.	EXPLANATION OF VOTE
Ich befürchte, daß die zwei Änderungsanträge des Europäischen Parlaments den Text unnötig verkomplizieren und daß die Forderung nach jährlicher Information schon von dem neuen Vorschlag abgedeckt wird.	Mr President, before leaving for Strasbourg, the pensioners who took me to the airport asked me "Is there going to be a debate about beer on Friday morning?"
Diese Informationen werden auch im Internet veröffentlicht.	I replied "Yes, certainly."
Daher kann die Kommission diese Änderungsanträge beim jetzigen Stand der Dinge nicht akzeptieren.	"Well, you have to give an explanation of vote and say that we pensioners are in favour of the production and development of beer."
Herr Präsident!	We are in favour not just because ten years ago, the Pensioners' Party put forward as candidate for Rome' s mayor the model Solveig Tubing, who was born in Berlin and was a great connoisseur and lover of beer, but also because my own personal studies on beer show that drinking it makes you younger.
Erstens: Ich würde mich freuen, die Frau Kommissarin nach Kloster Andechs in Bayern einzuladen, wo sieben verschiedene Biersorten gebraut werden ...	I know that welfare institutions and governments are against developing beer, because this means that they have to pay out pensions for longer, but as representative of the Pensioners' Party, I am in favour.
Zweitens möchte ich ankündigen, daß nächstes ...	Extension of exceptional financial assistance to Tajikistan
(Der Präsident entzieht dem Redner das Wort.)	The next item is the debate on the report (A5-0093/1999) by Mr Savary, on behalf of the Committee on Industry, External Trade, Research and Energy, on the proposal for a Council decision modifying Decision 97/787/EC granting exceptional financial assistance to Armenia and Georgia in order to extend it to Tajikistan [COM(1999) 391 - C5­0171/1999 - 1999/0172(CNS)].
Herr Posselt, dies ist keine Geschäftsordnungsfrage.	Mr President, I thought, since I represent the Bordeaux area, that you were giving me the floor so that I could answer my Bavarian colleague on the subject of Bordeaux wine.
Die Aussprache ist geschlossen.	However, it seems that you are asking me to speak on Tajikistan instead and, as I have five minutes, I shall try to be as clear as possible about an issue that is perhaps rather esoteric and complicated.
Wir kommen nun zur Abstimmung.	It concerns exceptional aid to Tajikistan which is, as you know, a small country located between Uzbekistan, Kazakhstan, China and Afghanistan.
(Das Parlament nimmt die legislative Entschließung an.)	There is a history to this issue and really what I would like to do today is to close a subject that began in 1991 with a loan of EUR 1200 million to the Newly Independent States when the Soviet Union collapsed.
Erklärung zur Abstimmung	The loan has been repaid by all of the States apart from three.
Herr Präsident, vor meinem Abflug nach Straßburg haben die Rentner, die mich zum Flughafen begleiteten, gefragt: "Wird am Freitag das Thema Bier behandelt werden? "	In 1997, three States were experiencing difficulties and were seriously behind in their repayments: Georgia, Armenia and Tajikistan.
Ich antwortete: "Ja, sicherlich ".	Thus the Parliament was informed in 1997 of a proposal by the Commission, which aimed to reschedule and restructure these three countries' debts.
"Dann mußt Du eine Erklärung zur Abstimmung abgeben und sagen, wir Rentner seien für die Herstellung und die Förderung von Bier ".	It was therefore decided to put in place two types of financial assistance.
Wir sind nicht nur deswegen dafür, weil die Rentnerpartei vor zehn Jahren als Kandidatin für das Amt des Bürgermeisters in Rom das in Berlin geborene Topmodell Solveig Tubing, eine große Bierliebhaberin und ­expertin, aufgestellt hat, sondern auch, weil die von mir geführten Statistiken gezeigt haben, daß Biertrinken verjüngt.	On the one hand there would be loans - at the time EUR 245 million had been earmarked for loans to these three countries - and on the other hand, a gift of EUR 130 million, whose main objective was to reduce the burden of debt and to improve the ability of these countries to repay.
Zwar sind, wie ich weiß, die Vorsorgeeinrichtungen und die Regierungen gegen die Förderung von Bier, weil sie damit länger Renten zahlen müssen, aber als Vertreter der Rentnerpartei bin ich dafür.	1997 was also marked, and this is the crux of the issue, by a civil war in Tajikistan, a terrible civil war between the reigning power and the Islamic opposition.
Einbeziehung von Tadschikistan in eine Sonderfinanzhilfe	Parliament then proposed, on the basis of Mr Kittelmann' s report, to defer aid to Tajikistan and that is why, two years later, now that the situation has returned to normal, we are being asked today to reopen the matter.
Nach der Tagesordnung folgt die Aussprache über den Bericht (A5-0093/1999) von Herrn Savary im Namen des Ausschusses für Industrie, Außenhandel, Forschung und Energie über den Vorschlag für einen Beschluß des Rates zur Änderung des Beschlusses 97/787/EG über eine Sonderfinanzhilfe für Armenien und Georgien zwecks Einbeziehung von Tadschikistan (KOM(1999) 391 - C5­0171/1999 - 1999/0172(CNS)).	In fact, although the situation in Tajikistan has remained highly critical and worrying, in terms of politics as well as economics, it has gradually become more stable.
Herr Präsident, als Abgeordneter aus Bordeaux glaubte ich, Sie würden mir das Wort erteilen, um meinem bayerischen Kollegen eine Antwort zum Thema Bordeaux­Wein zu geben.	There has been an agreement between the different parties, which has been implemented and universally respected, even if security in the country is still subject to caution due to the presence of warlords and the powerful wave of Wahabi fundamentalism in Afghanistan.
Aber nein, ich soll zum Thema Tadschikistan sprechen, und da ich nur fünf Minuten habe, will ich mich so klar wie möglich ausdrücken, obwohl der Gegenstand vielleicht etwas esoterisch und schwierig ist.	In terms of economics, the country has made great efforts under the auspices of the IMF and is benefiting from a structural adjustment facility provided by that organisation.
Es geht um eine Sonderfinanzhilfe für Tadschikistan, ein kleines Land, das, wie Sie wissen, zwischen Usbekistan, Kasachstan, China und Afghanistan gelegen ist.	We, the European Union, are therefore being asked to re-establish contact with Tajikistan and to implement a restructuring of the debt as today, around EUR 73 million is still outstanding.
Dieses Dossier hat eine Vorgeschichte, und was ich Ihnen heute vorschlage, ist, ein Dossier abzuschließen, das 1991, zum Zeitpunkt des Zerfalls der Sowjetunion, mit einem Darlehen in Höhe von 1 Milliarde Euro für die Neuen Unabhängigen Staaten eröffnet wurde.	What the Commission is proposing is actually to repeat what was done for Georgia and Armenia, which was to make provision for a new loan which would enable Tajikistan to repay the previous one but on much more favourable terms in order to give this country some breathing space, and to make provision for a gift of EUR 35 million for the period 2000-2004, in order to reduce the burden of debt.
Dieses Darlehen wurde von allen Staaten, mit drei Ausnahmen, zurückgezahlt.	Unfortunately, I have to say that the Commission' s proposal is extremely contradictory.
Im Jahre 1997 befanden sich drei Staaten in Schwierigkeiten und hatten große Zahlungsrückstände: Georgien, Armenien und Tadschikistan.	We are in fact being asked to make a loan of EUR 75 million and a gift of EUR 35 million and now we see that no more budgetary funds are available for donations and that, in 1999, we only budgeted for the donations granted to Armenia and Georgia, donations which are due to end in 2001.
Deshalb wurde dem Parlament im Jahre 1997 ein Vorschlag der Kommission vorgelegt, der darauf abzielte, eine Umschuldung für diese drei Länder vorzunehmen.	As a result and quite logically, we, the Committee on Industry, within whose competence this matter essentially falls, have been told by the Committee on Budgets that under no circumstances could we endorse donations which have not been budgeted for today and which have not been provided for in the financial perspective, particularly in Category 4, which, as you know, is already under pressure through trying to finance Kosovo.
Daraufhin wurde beschlossen, zwei Arten von Finanzhilfe zu gewähren: einerseits Darlehen, wobei zum damaligen Zeitpunkt für Darlehen an diese drei Länder 245 Millionen Euro vorgesehen waren, und andererseits Zuschüsse in Höhe von 130 Millionen Euro.	Therefore, the compromise which we have reached with the Committee on Budgets consists effectively of only keeping the loan of EUR 75 million whilst agreeing - a position of the Committee on Industry which I think has been understood by the Committee on Budgets - that Tajikistan should also be able to benefit from supplementary aid in order to reduce the monthly debt repayment of EUR 200 000 which it cannot afford.
Das wesentliche Ziel bestand darin, die Schuldenlast dieser Länder zu mildern und ihre Rückzahlungsfähigkeit zu verbessern.	Tajikistan is, in fact, the poorest of the Newly Independent States and the one that we absolutely have to stabilise because, rather like Chechnya and for other reasons besides, it is a country that could endanger the whole region, particularly because of its strategic position with regard to Kazakhstan and Uzbekistan, which are very rich countries.
Im Jahre 1997 kam es auch, und da sind wir beim Kern des Problems, werte Kolleginnen und Kollegen, zum Bürgerkrieg in Tadschikistan, einem äußerst grausamen Bürgerkrieg zwischen der dortigen Regierung und der islamischen Opposition.	We have consequently tabled a series of amendments.
Deshalb hatte das Parlament auf der Grundlage des Berichts unseres Kollegen Kittelmann vorgeschlagen, die Hilfe für Tadschikistan zeitweilig auszusetzen, und aus diesem Grunde fordert man uns heute, zwei Jahre später, nachdem die Situation sich normalisiert hat, auf, dieses Dossier wieder zu öffnen.	Firstly, amendments that endorse the donation; then amendments which point out to the Council and the Commission their contradictions by telling them that it would be desirable to grant direct aid, but by financing it under another line, and here I am thinking of TACIS; and finally, amendments concerning conditions: monitoring the way the funds are used, the political and democratic conditions and the monitoring of the Parliament.
Zwar ist die Situation in Tadschikistan in politischer wie in wirtschaftlicher Hinsicht nach wie vor kritisch und beunruhigend, jedoch ist seit zwei Jahren ein allmählicher Stabilisierungsprozeß zu verzeichnen.	Mr President, Commissioner, Tajikistan is not only the poorest of all the countries formed from the Soviet Union, it has also been the one to suffer the most on account of the turmoil caused by tribal feuding, which ultimately escalated into civil war.
Zwischen den Parteien wurde ein Friedensabkommen geschlossen, das auch umgesetzt und im allgemeinen eingehalten wird, obwohl die Sicherheit in diesem Land aufgrund der Präsenz von Kriegsherren und des starken Drucks seitens des wahhabitischen Fundamentalismus aus Afghanistan nach wie vor gefährdet ist.	The country failed to grasp how to employ the financial aid provided so far in a targeted manner.
Wirtschaftlich gesehen unternimmt das Land große Anstrengungen unter der Schirmherrschaft des IWF, der ihm auch eine Strukturanpassungsfazilität gewährt hat.	The situation has only calmed down to some extent over the last few months, once the warring parties had ceased hostilities and resolved that their next step would be to form a coalition government.
Wir als Europäische Union sind nun also aufgefordert, den Kontakt zu diesem Land wiederherzustellen und eine Umschuldung vorzunehmen, bei der es heute um etwa 73 Millionen Euro geht.	General free elections are set for March 2000.
Der Vorschlag der Kommission zielt darauf ab, in gleicher Weise vorzugehen wie im Falle von Georgien und Armenien, d. h. ein neues Darlehen zu gewähren, das der Rückzahlung des vorhergehenden dient, jedoch zu wesentlich günstigeren Bedingungen, so daß dieses Land wieder etwas freier atmen kann, und zudem einen Zuschuß in Höhe von 35 Millionen Euro für den Zeitraum 2000-2004 vorzusehen, um die Schuldenlast zu verringern.	The international donor community, which includes Swiss organisations for the most part, is now prepared to carry on where it left off delivering financial aid, but with certain provisos.
Bedauerlicherweise muß ich aber sagen, daß der Vorschlag der Kommission äußerst widersprüchlich ist.	Now that the situation has abated and there are more favourable prospects for future progress overall, the Savary report now attempts to provide renewed support for the macroeconomic financial aid for this country in the form of loans.
Man fordert uns auf, ein Darlehen in Höhe von 75 Millionen Euro und einen verlorenen Zuschuß in Höhe von 35 Millionen Euro zu gewähren, um dann festzustellen, daß gar keine Haushaltmittel für Zuschüsse mehr zur Verfügung stehen und daß man für 1999 lediglich die Zuschüsse für Armenien und Georgien in den Haushalt eingestellt hat, die im Jahre 2001 auslaufen müßten.	We hope that this will make it sufficiently clear to Tajikistan that it needs to improve its state machinery by embracing democratic development and undertaking the necessary reforms.
Demzufolge hat logischerweise der Haushaltsausschuß uns, dem Industrieausschuß, der im Grunde zuständig ist, zu verstehen gegeben, daß wir auf keinen Fall Zuschüsse genehmigen könnten, die heute weder im Haushalt noch in der Finanziellen Vorausschau vorgesehen sind, vor allem in Rubrik 4, die bekanntlich schon wegen des Versuchs der Kosovofinanzierung stark unter Druck geraten ist.	However, the financial aid in the form of loans should only be granted if there is a real possibility of the European Union being able to properly monitor the situation, if the process of national reconciliation continues and the elections, in particular the parliamentary elections set for March, are free and democratic.
So haben wir nun also mit dem Haushaltsausschuß den Kompromiß geschlossen, daß wir de facto nur das Darlehen in Höhe von 75 Millionen Euro gewähren, wobei wir uns allerdings darüber einig sind - und diesen Standpunkt des Industrieausschusses hat, glaube ich, auch der Haushaltsausschuß verstanden - daß Tadschikistan auch eine zusätzliche Hilfe erhalten müßte, um den monatlichen Schuldendienst zu senken, dessen Höhe von 200 000 Euro für dieses Land unerträglich ist.	As Mr Savary rightly said, this is also what we aim to achieve with proposed Amendments Nos 8 and 9, to which we give our unequivocal support.
Tadschikistan ist in der Tat das ärmste Land unter den Neuen Unabhängigen Staaten und muß unbedingt stabilisiert werden, denn ähnlich wie Tschetschenien und aus anderen Gründen könnte dieses Land zu einer Gefahr für die ganze Region werden, vor allem aufgrund seiner strategischen Lage gegenüber den reichen Ländern Kasachstan und Usbekistan.	If Tajikistan' s creditworthiness is to be restored, then the proposal in Budget 2000 is also to be welcomed.
Aus diesem Grund haben wir eine Reihe von Änderungsanträgen eingebracht.	The rapporteur, Mr Bourlanges, has just confirmed to me that as far as this is concerned, a commentary is to provide for a particular form of financial aid to be made available again under the TACIS programme.
Einige Änderungsanträge zielen darauf ab, den Zuschuß zu validieren.	On a final note, I would like to say that the PPE group supports this report notwithstanding all the associated risks.
Andere sollen den Rat und die Kommission auf ihre Widersprüche aufmerksam machen und ihnen nahelegen, daß eine Direkthilfe wünschenswert wäre, die aber aus einer anderen Haushaltslinie finanziert werden müßte, ich denke da beispielsweise an TACIS.	It represents a renewed, hopefully successful attempt to resume and promote economic and technical cooperation with Tajikistan.
Weitere Änderungsanträge schließlich beziehen sich auf die Bedingungen: Kontrolle der Mittelverwendung, politische und demokratische Bedingungen und Kontrolle durch das Parlament.	Mr President, the loan which Tajikistan will receive equals this small and poor country' s share in an outstanding debt to the former Soviet Union.
Herr Präsident, Frau Kommissarin, liebe Kolleginnen und Kollegen!	As such, this will not solve any problems within Tajikistan.
Tadschikistan ist nicht nur das ärmste Land der Nachfolgestaaten der Sowjetunion, es hat auch in den letzten fünf Jahren am meisten unter den Wirren der Stammesfehden gelitten, bis diese sich schließlich zu einem Bürgerkrieg ausgeweitet haben.	The loan only prevents the outstanding debts from continuing to exist.
Das Land hat es nicht verstanden, die bisher gewährte Finanzhilfe zielführend einzusetzen.	Central Asia, the majority of whose population is Turkish-speaking and a small part of which is Iranian-speaking, was conquered in the previous century by the Russian tsarist empire.
Erst in den letzten Monaten kam es zu einer gewissen Beruhigung der Situation, nachdem die Bürgerkriegsparteien die Feindseligkeiten eingestellt und sich entschlossen haben, demnächst eine Koalitionsregierung zu bilden.	This empire did not look for colonies far from home or overseas, like most Western European States, but close by.
Allgemeine freie Wahlen stehen für März 2000 in Aussicht.	Although they were decolonised in 1922, they have remained linked to Russia in the form of Federal States of the Soviet Union.
Die internationale Gebergemeinschaft, darunter auch vor allem Schweizer Organisationen, ist jetzt wieder bereit, die Finanzhilfe unter bestimmten Bedingungen aufzunehmen.	The boundaries drawn by Stalin between the various linguistic and cultural regions in the ' 20s and ' 30s are now state borders.
Nach Beruhigung der Lage und insgesamt günstigeren Entwicklungschancen für die Zukunft versucht nun der Bericht Savary, die makroökonomische Finanzhilfe für dieses Land in Form von Darlehen wieder zu unterstützen.	This prolonged European influence means that we in the European Union should feel especially responsible for the vicissitudes of the five States which appeared after the collapse of the Soviet Union.
Wir hoffen, daß damit Tadschikistan ein ausreichend deutliches Signal erhält, um seine staatliche Organisation im Sinne einer demokratischen Entwicklung zu verbessern und die notwendigen Reformen anzugehen.	The economy and environment are in a sad state of affairs in all fifteen States.
Die Finanzhilfe auch in Form von Darlehen sollte aber nur gewährt werden, wenn eine ordentliche Kontrolle der Finanzhilfe von seiten der Europäischen Union tatsächlich möglich ist, wenn der Prozeß der nationalen Aussöhnung weitergeht und die Wahlen und insbesondere die Parlamentswahlen im März 2000 frei und demokratisch organisiert sein werden.	Authoritarian regimes have come to power and leave little or no scope for political opponents.
Dies ist auch das Ziel, und das hat Herr Savary zu Recht gesagt, unserer Änderungsanträge 8 und 9, die wir ausdrücklich gutheißen.	By means of referendums and intimidation, some presidents have their periods of office extended by ten years, without there being rival candidates.
Wenn nun die Kreditfähigkeit und Kreditwürdigkeit von Tadschikistan wieder hergestellt werden sollte, ist auch der Vorschlag im Haushalt 2000 zu begrüßen.	In this respect, Tajikistan is no exception.
Der Berichterstatter, Herr Bourlanges, hat mir gerade bestätigt, daß dort in einem Kommentar vorgesehen werden soll, daß eine gewisse Form der Finanzhilfe im Rahmen des TACIS-Programms dann wieder gewährt werden kann.	Should European money be spent on a country like this?
Lassen Sie mich abschließend sagen: Die EVP-Fraktion unterstützt diesen Bericht, trotz aller Risiken, die damit verbunden ist.	In general, my group is not in favour of funding undemocratic regimes.
Es ist der erneute, hoffentlich erfolgreiche Versuch, die wirtschaftliche und technische Zusammenarbeit mit Tadschikistan wieder aufzunehmen und voranzubringen.	All too often, we have noticed that they receive funding in the expectation that they will regard this money as a reward for taking small steps towards greater democracy and human rights and as an encouragement to take further such steps.
Herr Präsident!	In practice, however, this method does not work, as we have since found out in Turkey and Russia.
Der für Tadschikistan vorgesehene Kredit ist genauso groß wie der Anteil dieses kleinen armen Landes an einer noch nicht beglichenen Schuld der ehemaligen Sowjetunion.	The funding is received, but the situation does not improve.
In Tadschikistan wird damit kein einziges Problem gelöst.	With the collapse of the Soviet Union, Tajikistan has reverted to the situation in the nineteenth and at the beginning of the twentieth century.
Der Kredit verhindert nur, daß die nicht getilgten Schulden bestehenbleiben.	There are several, regionally powerful families and groups which are fighting each other in a situation where warlords seize upon political and religious differences as an excuse to justify armed action.
Zentralasien mit einer mehrheitlich türkisch- und zu einem kleinen Teil persischsprachigen Bevölkerung wurde im letzten Jahrhundert vom russischen Zarenreich erobert.	The fate of Tajikistan largely depends upon what is happening in its immediate surroundings, such as the hopeless, violent conflict in Afghanistan.
Dieses Reich suchte seine Kolonien nicht weit von zu Hause und in Übersee wie die meisten westeuropäischen Staaten, sondern in der unmittelbaren Umgebung.	A large proportion of the Tajikistani population lives in north-east Afghanistan, the area which is not in the hands of the Taliban.
Ab 1922 waren diese Gebiete zwar keine Kolonien mehr, aber in Form von Republiken der Sowjetunion sind sie mit Rußland verbunden geblieben.	The North of Tajikistan stretches out as far as the densely populated Fergana Valley which is partly located in Uzbekistan and is completely integrated into the economy and road network of this neighbouring country.
Die in den 20er und 30er Jahren von Stalin zwischen den verschiedenen Sprach- und Kulturräumen gezogenen Grenzen sind heute Staatsgrenzen.	As a frontline area flanked, on the one hand, by the Russian sphere of influence and, on the other hand, by Islamic fundamentalism in Afghanistan, the present Tajikistani State has little chance of survival.
Aufgrund des langandauernden europäischen Einflusses können wir uns in der Europäischen Union für das Wohl und Wehe der hier nach dem Zerfall der Sowjetunion entstandenen fünf Staaten besonders verantwortlich fühlen.	The only reason to inject European funding into Tajikistan despite all this is that funding increases the chance of survival of the Tajikistani population and offers more chance of peace than there would be without such aid.
In allen 15 Staaten ist es um die Wirtschaft und um die Umwelt schlecht bestellt.	This is the reason why my group can nevertheless agree with the proposals made in the Savary report.
Autoritäre Regimes, die politischen Gegnern wenig oder keinen Spielraum lassen, sind an die Macht gekommen.	Mr President, for our part, we will not be voting for the Savary report.
Manche Präsidenten lassen ihre Amtszeit ohne Gegenkandidaten durch Referenden und Einschüchterung um zehn Jahre verlängern.	This is both for reasons concerning the choice of this country and out of more general considerations involving financial aid.
Insofern bildet Tadschikistan keine Ausnahme.	Although, of course, we have nothing against the sovereign State of Tajikistan, we nevertheless do not think that European States should drop their priorities, or to be more precise, the priority that they set a long time ago on the subject of cooperation.
Muß Europa denn einem solchen Land Geld geben?	This priority has now been in force for more than a quarter of a century through the Lomé Agreements.
Meine Fraktion ist generell nicht dafür, daß undemokratische Regimes finanziell unterstützt werden.	For obvious reasons, which concern history as well as geography, Europeans felt it necessary to embark, throughout the 1970s, on a major course of cooperation with the countries of Africa, the Caribbean and the Pacific in a way which is, moreover, highly original, known as the Lomé Agreements, which enable us to offer our Southern partners the benefits of stable prices for the produce which constitute their essential resources, protecting them from all-out free trade.
Wir sehen allzu oft, daß sie Geld erhalten, da erwartet wird, sie sähen dieses Geld als Belohnung und einen Anreiz, kleine Schritte hin zu mehr Demokratie und Menschenrechten zu setzen.	Today we see only too well how this ruins the weakest economies.
In der Praxis funktioniert diese Methode nicht, wie wir inzwischen in der Türkei und in Rußland sehen können.	Now under the battering, not from globalisation but from the globalist ideology, which European countries have accepted without closer examination, we have seen the ACP agreements being slowly dismantled over several years, their basic principles denied and, above all, we have seen reductions in several European countries' contributions to the EDF.
Man nimmt das Geld entgegen, aber die Situation verbessert sich nicht.	Now, at the same time, so-called exceptional financial aid to the most diverse countries in the world is multiplying, without any overall plan emerging, which means that our cooperation policy is nothing but a vague, huge scratching of the surface or, to sum it up, it is no longer a policy at all.
Mit dem Zerfall der Sowjetunion herrscht in Tadschikistan wieder die Situation wie im 19. und zu Beginn des 20. Jahrhunderts.	To this particular consideration we can add a second.
Verschiedene regional mächtige Familien und Gruppen bekämpfen einander, wobei politische und religiöse Unterschiede von den Kriegsherren als Deckmantel benutzt werden, um den Einsatz von Waffengewalt zu rechtfertigen.	Tajikistan may have been spared the economic problems described in the report, moreover like so many other countries in the world, but it is nevertheless the victim of an ill-considered opening up of its borders and of the huge game waged by empires.
Das Wohl und Wehe Tadschikistans ist eng verbunden mit dem der näheren Umgebung, wie der aussichtslose, gewalttätige Konflikt in Afghanistan.	For our part, the best solution we can see would be to restore a new world trade order, which respects the sovereignty of States, their pace and their modes of development, and which also respects their traditions, traditions which we will not be able to make vanish with a wave of a magic wand just by imposing an election, human rights and what we quite hastily call democracy.
Ein großer Teil des tadschikischen Volks lebt im Nordosten Afghanistans, dem Gebiet, das nicht von den Taliban beherrscht wird.	Mr President, the political tide in Tajikistan seems to be turning.
Der Norden Tadschikistans erstreckt sich bis in das dichtbevölkerte Ferganabecken, das teilweise in Usbekistan liegt und mit der Wirtschaft und den Verkehrsverbindungen dieses Nachbarlandes eng verzahnt ist.	Only last week, President Ragmanov called for parliamentary elections to be held next spring.
Als Frontgebiet zwischen dem russischen Einflußbereich und dem islamischen Fundamentalismus in Afghanistan hat der heutige Staat Tadschikistan kaum Überlebenschancen.	After months of tug-of-war between the government and the opposition, agreement has finally been reached regarding the new electoral law.
Der einzige Grund, dennoch Geld in dieses Land zu stecken, besteht darin, daß dies die Chancen des tadschikischen Volks zu überleben erhöht und dadurch bessere Aussichten auf Frieden geboten werden als ohne einen solchen Beitrag.	I should point out, however, that these developments mark only the beginning of the democratisation process.
Deshalb kann meine Fraktion den Vorschlägen im Bericht Savary dennoch zustimmen.	Tajikistan still shows features which are incompatible with a democratic constitutional state.
Herr Präsident, wir werden dem Bericht Savary nicht zustimmen, und zwar sowohl aus Gründen, die mit der Wahl dieses Landes zu tun haben, als auch aus allgemeineren Erwägungen im Zusammenhang mit der Finanzhilfe heraus.	Indeed, the downside of the present positive developments is that during the next elections, a number of parties will remain on the sidelines.
Obwohl wir natürlich nichts gegen den souveränen Staat Tadschikistan haben, meinen wir nicht, daß die europäischen Staaten von Prioritäten oder besser gesagt der Priorität, die sie sich auf dem Gebiet der Entwicklungspolitik seit langem gesetzt haben, abrücken sollten.	They are excluded from participating.
Diese Priorität wurde vor mehr als einem Vierteljahrhundert durch die Lomé­Abkommen umgesetzt.	This is hardly surprising as permission to participate in elections is still in the hands of former communists.
Aus allgemein bekannten Gründen, die mit der Geographie, aber auch mit der Geschichte zu tun haben, sahen sich die Europäer im Laufe der 70er Jahre der Notwendigkeit gegenüber, eine umfangreiche Aktion der Zusammenarbeit mit den Ländern Afrikas, der Karibik und des Pazifik zu starten.	This remark regarding Tajikistan' s democratic status does not detract from the fact that quite a few changes have already taken place.
Dabei wählten sie eine originelle Form, die unter dem Namen Lomé­Abkommen bekannt wurde, die es unseren Partnern im Süden ermöglichte, für die Lebensmittel, die den Hauptteil ihrer Ressourcen ausmachen, stabile Preise zu erzielen, ohne einem ungebremsten Freihandel ausgesetzt zu sein, von dem man heute nur allzugut weiß, daß er die anfälligsten Wirtschaften ruiniert.	As such, international organisations and bilateral donors no longer see good reason for suspending aid to Tajikistan.
Nun erleben wir, wie unter dem Einfluß nicht der Globalisierung, sondern der globalistischen Ideologie, die die europäischen Nationen ohne näheres Hinsehen akzeptiert haben, die AKP­Abkommen bereits seit mehreren Jahren allmählich demontiert und ihre Grundprinzipien negiert werden und vor allem, daß der Beitrag mehrerer europäischer Länder zum EEF immer geringer wird.	Even the European Commission, with the proposal it is making, seems to think it should put its oar in.
Gleichzeitig nehmen die sogenannten Sonderfinanzhilfen für die verschiedensten Länder der Erde zu, ohne daß ein Gesamtplan erkennbar wäre, so daß unsere Entwicklungshilfe nur noch in einer vagen und breitangelegten Gießkannenaktion besteht, also gar keine Politik mehr ist.	However, the Commission is losing sight of one important factor.
Dieser Überlegung möchte ich noch eine zweite anfügen.	Earlier this year, the three institutions of the European Union concluded the interinstitutional agreement for a period of seven years, stipulating the financial ceilings for the various policy areas.
Wenn Tadschikistan sich heute den im Bericht genannten wirtschaftlichen Schwierigkeiten gegenübersieht, wie übrigens sehr viele Länder auf der Welt, so liegt das zweifellos daran, daß es zum Opfer einer unüberlegten Grenzöffnung und zum Spielball der Weltmächte wurde.	I would like to remind the Commission of this.
Wir sehen unsererseits keine bessere Lösung als die Wiederherstellung einer neuen internationalen Handelsordnung, die die Souveränität der Staaten, das Tempo und die Modalitäten ihrer Entwicklung respektiert, sowie auch ihre Traditionen, die sich nicht wie mit einem Zauberstab wegwischen lassen, nur weil wir Wahlen, Menschenrechte und das, was wir nur allzu übereilt Demokratie nennen, durchgesetzt haben.	In the proposal to grant aid to Tajikistan, this agreement is not given much consideration.
Herr Präsident!	Neither the urgent appeal by the IMF and World Bank to the European Union to increase aid to Tajikistan nor the argument of moral duty in the light of Tajikistan' s debts to the Union are in themselves good enough reasons to grant aid.
Die politische Stimmung in Tadschikistan scheint umzuschlagen.	We are first of all faced with the European Union' s financial limitations.
Noch letzte Woche kündigte Präsident Rachmonow Parlamentswahlen für das nächste Frühjahr an.	The above agreement does not allow for making gifts to Tajikistan.
Nach monatelangem Tauziehen zwischen Regierung und Opposition wurde jetzt endlich eine Übereinkunft über das neue Wahlrecht erzielt.	Moreover, we have recent experiences of entering into financial commitments which we cannot honour, as illustrated in the reconstruction of Kosovo.
Dabei merke ich aber an, daß diese Entwicklung nur den Beginn des Demokratisierungsprozesses kennzeichnet.	The Commission has pledged a sum of EUR 500 million while the Member States do not want to make the necessary increase in the European budget at this stage.
Tadschikistan weist noch immer Merkmale auf, die nicht zu einem demokratischen Rechtsstaat passen.	A vague declaration of intent has since been drafted by the Council to prevent similar problems from occurring in future, but it remains to be seen what will come of this.
Die Kehrseite der heutigen positiven Entwicklungen ist nämlich, daß bei den kommenden Wahlen einige Parteien wiederum an der Seitenlinie stehen werden.	Kosovo is no better off at the moment.
Sie sind von der Teilnahme ausgeschlossen, was nicht verwunderlich ist, denn über die Zulassung zu Wahlen entscheiden noch immer Exkommunisten.	Aid has been reduced to EUR 360 million and also spread over several years.
Diese Randbemerkung zu dem demokratischen Gehalt Tadschikistans ändert nichts daran, daß sich dennoch etwas verändert hat.	This incident has given me grave concerns regarding the Member States' willingness to make concessions once again within the context of aid to Tajikistan, even if only relatively small amounts are involved.
Internationale Organisationen und bilaterale Geber erachten es daher nicht länger als begründet, die Hilfeleistungen für Tadschikistan auszusetzen.	Member States find it hard to sell the idea within their own countries if the outcome of the negotiations at the Berlin Summit are undermined by reality.
Auch die Europäische Kommission meint, mit ihrem Vorschlag ihr Scherflein dazu beitragen zu müssen, übersieht dabei jedoch eine wichtige Tatsache.	Apart from a limited budget, the European Union has little political interest in Tajikistan.
Im Frühjahr dieses Jahres haben die drei Institutionen der Europäischen Union die interinstitutionelle Vereinbarung für einen Zeitraum von sieben Jahren abgeschlossen.	The geographical remoteness makes it impossible to have any real influence on the democratisation process.
Darin werden die finanziellen Obergrenzen für die verschiedenen Politikbereiche angegeben.	Although the European Union has an interest in being surrounded by large, stable regions, the tools it has available in order to achieve this are still very limited.
Daran möchte ich die Kommission heute erinnern.	All this does not mean that we cannot do anything at all for Tajikistan.
In dem Vorschlag für die Finanzhilfe an Tadschikistan findet diese Vereinbarung kaum Berücksichtigung.	On humanitarian grounds, I do agree with special aid as far as the loan component is concerned, but the gift component should be scrapped for the reasons I have outlined above.
Sowohl der eindringliche Appell des IWF und der Weltbank an die Europäische Union, die Hilfe für Tadschikistan aufzustocken, als auch das Argument der moralischen Verpflichtung wegen der Schulden Tadschikistans gegenüber der Union sind an sich keine Gründe für eine solche Finanzhilfe.	I would also like to urge the Commission to ask Tajikistan' s bilateral donors and the Member States to grant special aid to this country on an individual basis.
Wir haben es an erster Stelle mit den finanziellen Beschränkungen der Europäischen Union zu tun.	After all, the scope of the budget of the national Member States is, politically speaking, less of a sensitive issue.
Die erwähnte Vereinbarung bietet keinen Spielraum für Geschenke an Tadschikistan.	Finally, I would like to strongly advise the Commission, out of moral considerations, to resume the projects under TACIS for Tajikistan as soon as possible.
Außerdem haben wir erst vor kurzem im Zusammenhang mit dem Wiederaufbau im Kosovo Erfahrungen mit dem Eingehen von finanziellen Verpflichtungen gemacht, denen wir nicht nachkommen können.	In this respect, we have to monitor the situation closely in order to ensure that the money ends up where it is needed, namely with the Tajikistani population, which is suffering under grinding poverty.
Die Kommission hat 500 Millionen Euro zugesagt, die Mitgliedstaaten wollen vorerst jedoch nicht die dafür benötigte Erhöhung des EU-Haushalts vornehmen.	Mr President, we passed the budget yesterday and the steps that you decided ought to be taken in Category 4 will be very important in terms of Europe' s future.
Mittlerweile liegt zwar eine vage Absichtserklärung des Rats vor, um derartige Probleme künftig zu vermeiden, aber ich muß noch sehen, was daraus wird.	Commissioner, we are today discussing a form of special aid that will serve, in essence, to promote the stabilisation of a part of the world which could cause problems for us too, if we fail to get involved there.
Dem Kosovo ist damit in diesem Moment nicht geholfen.	It is our duty to ensure that in Tajikistan, Armenia and Georgia, greater store is set by democracy, the market economy and security issues in future.
Die Hilfe wurde auf 360 Millionen Euro reduziert und zudem über mehrere Jahre gestreckt.	There was severe hyperinflation in Tajikistan during the civil war and the country' s production output was down by two-thirds.
Insofern bezweifle ich ernsthaft die Bereitschaft der Mitgliedstaaten, im Rahmen der Finanzhilfe für Tadschikistan erneut Konzessionen zu machen, wenngleich es hier um relativ geringe Beträge geht.	One can only imagine what kind of impact this has on family units and individuals living in such a country.
Die Mitgliedstaaten können es zu Hause schlecht verkaufen, wenn ihre Verhandlungsergebnisse beim Berliner Gipfel durch die Wirklichkeit unterlaufen werden.	In 1997 there was economic growth again of an unprecedented 1.7%.
Neben einem begrenzten Haushalt hat die Europäische Union politisch gesehen in Tadschikistan wenig zu suchen.	National economic growth of production output was 5.3%; the starting point being a very low base level of course, as I have already mentioned.
Die weite Entfernung macht einen nachhaltigen Einfluß auf den Demokratisierungsprozeß unmöglich.	In December 1998 inflation fell to below 3%, i.e. it was possible to detect a degree of stabilisation here as well, and in the 1998 financial year the balance of payments including invisible trade rose from 5.5 to at least 15.2% of Gross Domestic Product.
Der Europäischen Union ist zwar an großen stabilen Regionen in ihrer Umgebung gelegen, aber sie verfügt nach wie vor nur über recht begrenzte Instrumente, um das zu erreichen.	The fact that the country has outstanding debts totalling USD 1,263 million, that is to say, 98% of GDP, is, of course, a major problem; it is clear that the situation has been pushed to the limit.
Damit ist nicht gesagt, wir könnten nichts für Tadschikistan tun.	Since Tajikistan is the poorest country amongst the Newly Independent States, it is up to us to combat the poverty in which the children and family units live there, and particularly in the run-up to Christmas, it behoves those of us that live in comfort to think of those that do not enjoy the standard of living that we do today.
Aus humanitären Erwägungen bin ich mit dieser Sonderfinanzhilfe, was die Kreditkomponente betrifft, einverstanden.	I therefore believe that we need to have clearly defined programmes which have certain conditions attached, and of course that usage of these programmes must be founded on existing legal bases.
Die Geschenkkomponente muß jedoch aus den genannten Gründen gestrichen werden.	What we are most concerned about here is ensuring that the budgetary control stipulations are adhered to.
Des weiteren möchte ich bei der Kommission darauf drängen, daß die bilateralen Geber Tadschikistans und die Mitgliedstaaten aufgefordert werden, diesem Land individuell besondere Hilfe zukommen zu lassen.	Of course, we must also realise that the grants that are provided must be made conditional on orderly elections taking place.
Der Haushaltsspielraum der einzelnen Mitgliedstaaten ist in politischer Hinsicht nämlich weniger sensibel.	Elections are prospectively set for March 2000 and what we are concerned about is giving Tajikistan the incentive to push democracy through.
Abschließend möchte ich die Kommission dringend bitten, die Projekte für Tadschikistan aus dem TACIS-Programm aus moralischen Überlegungen so schnell wie möglich wieder aufzunehmen.	It is important from the point of view of the people for disputes not to be dealt with on the streets or in a civil war but in the parliaments between the different groups playing by the same rules.
Dabei müssen wir streng darauf achten, daß das Geld auch die Zielgruppe erreicht, nämlich die tadschikische Bevölkerung, denn sie leidet unter bitterer Armut.	I believe that Europe could serve as a very useful model for all the regions in question, with a view to achieving a functioning market economy, that is to say a socio-economic market economy, establishing democratic conditions and seeing to it that the citizen can rest assured that conflicts will be dealt with in the parliaments and that there will be security, and I believe that we need to export our concept of security rather than import crime from these countries.
Herr Präsident, wir haben gestern den Haushalt beschlossen, und Sie haben hier in der Kategorie 4 Schritte beschlossen, die für die Zukunft Europas sehr wichtig sind.	Whilst we might well feel ourselves to be secure here in this Parliament, in fact four women were murdered a few days ago in the vicinity of Strasbourg.
Frau Kommissarin, wir sprechen heute über eine Sonderhilfe, die im Kern dazu dient, die Stabilisierung eines Teils der Welt voranzutreiben, der, wenn wir uns dort nicht engagieren, auch uns Probleme machen könnte.	So even if we suppose ourselves to be secure, we should still not let a single day pass without ensuring people' s security in their daily lives, both in Europe and in countries such as Armenia and Georgia.
Wir haben in Tadschikistan, Armenien und Georgien dafür zu sorgen, daß dort die Demokratie, die Marktwirtschaft und auch Sicherheitskomponenten in Zukunft mehr Bedeutung bekommen.	I would therefore like to conclude by extending my sincere thanks to all my fellow MEPs and also people that I work alongside, because it is quite evident that we are more than willing to take on responsibilities outside Europe and that we worry about peace in this world.
Wir hatten während des Bürgerkriegs eine starke Hyperinflation in Tadschikistan, die Produktion des Landes ist um zwei Drittel gesunken.	That is why I was particularly delighted that we were able to hand our President the Bethlehem light of peace yesterday.
Man muß sich vorstellen, was das für die einzelne Familie, für den einzelnen Menschen eines solchen Landes heißt.	I hope that peace will be with us over the Christmas period and that we also have before us the prospect of living in peace in the new millennium.
Im Jahr 1997 hat es erstmals wieder ein Wirtschaftswachstum von 1,7 % gegeben.	Mr President, were it not for the people of Tajikistan I would not be standing here today.
Das gesamtwirtschaftliche Wachstum der Produktion betrug 5,3 %; Ausgangspunkt war natürlich, wie ich schon erwähnt habe, eine sehr niedrige Basis.	During the First World War, in 1916, my grandfather was a prisoner of war working on the railways in what used to be Russia-Central Asia, and he has often told me that he was only able to survive these difficult years on account of the hospitality and helpfulness of the people of Tajikistan.
Im Dezember 98 ging dann die Inflation auf unter 3 % zurück, also auch hier war eine gewisse Stabilisierung zu sehen, und im Jahr 98 verbesserte sich auch die Leistungsbilanz von 5,5 auf immerhin 15,2 % des Bruttoinlandsprodukts.	But this is not why I am so keen to support Tajikistan' s cause, rather, unlike Mr Blokland, I believe that it is an issue that is of direct concern to us.
Der Schuldenstand mit 1.263 Millionen US$ bzw. 98 % des BIP ist natürlich ein großes Problem; man sieht, daß hier die Grenze erreicht ist.	Tajikistan is situated in an area enclosed by China and Russia, which are at odds in this region, and by the Islamic world and the Caspian Sea, where there are immense deposits of raw materials.
Da Tadschikistan das ärmste Land der Neuen Unabhängigen Staaten ist, gilt es für uns, dort die Armut zu bekämpfen, die Armut, die die Kinder und die einzelnen Familien trifft, und gerade jetzt in der Vorweihnachtszeit sollten wir, die im Wohlstand leben, auch an jene denken, denen es nicht so gut geht wie uns heute.	In my view, this region represents the Balkans of the future, a Balkans in microcosm, and that is why it is in our vital interest, particularly as a number of nuclear powers are established there, to stabilise this region and prevent ethnic conflicts taking place there from having an impact on the entire world.
Deshalb glaube ich, ist es auch notwendig, daß wir klar definierte und an Bedingungen geknüpfte Programme haben, und daß die Nutzung dieser Programme natürlich auf bestehenden Rechtsgrundlagen erfolgen muß.	That is why I believe that we need to help Tajikistan on its difficult way ahead by providing it with a loan, but also with outright grants, it being clear, in this respect, that we will have to call upon the Member States as our own budget will not accommodate this.
Hier geht es uns vor allem darum, daß die Haushaltskontrollvorschriften eingehalten werden müssen.	Of course, we must demand democracy and the rule of law but, at the same time, we must not apply uncalled-for standards.
Ferner ist festzustellen, daß natürlich die Zuschüsse, die gegeben werden, auch damit in Verbindung gebracht werden müssen, daß dort ordnungsgemäße Wahlen stattfinden.	For centuries, Tajikistan was subjected to colonial exploitation and for eighty years it was brutally suppressed by Soviet Communism.
Es werden im März 2000 voraussichtlich Wahlen stattfinden, und für uns geht es ja darum, auch Anreize zu schaffen, daß sich die Demokratie dort durchsetzt.	Today this small mountain race is making its way with difficulty and must not be made subject to European standards.
Es ist für die Menschen wichtig, daß Streitigkeiten nicht auf der Straße, nicht im Bürgerkrieg ausgetragen werden, sondern in den Parlamenten zwischen den verschiedenen Gruppen, und das mit gemeinsamen Spielregeln.	We must apply the same standards that we apply to developing countries; after all, we have been supporting the countries of Africa on the road to democracy for decades now, and the situation there still leaves much to be desired.
Ich glaube, daß unser Modell Europa für die ganze dortige Region von großem Nutzen sein könnte, nämlich daß die Marktwirtschaft funktioniert, die ökosoziale Marktwirtschaft, daß wir dort demokratische Verhältnisse bekommen, so daß sich der Bürger sicher sein kann, daß die Konflikte in den Parlamenten ausgetragen werden und daß es Sicherheit gibt, und ich glaube, wir sollten unsere Sicherheitskonzepte exportieren und nicht Kriminalität aus diesen Ländern importieren.	We have only been supporting Tajikistan for a few years now.
Selbst wenn wir uns hier im Parlament heute sicher fühlen, so hat es doch vor wenigen Tagen auch hier in der Umgebung von Straßburg vier Morde an Frauen gegeben.	Therefore, whilst we must demand certain rules of the game, we must also be patient towards the people of Tajikistan, heavily promote the elections to take place in the spring and recognise that this is not just an act that will do honour to Europe, rather it is in Europe' s own best interests to bring peace to this region.
Auch wenn wir uns also in Sicherheit wähnen, gilt es trotzdem tagtäglich in Europa und in diesen Ländern, wie Armenien und Georgien, für die tägliche Sicherheit der Bevölkerung zu sorgen.	Mr President, Commissioner, the European Union has set itself four major objectives.
Deshalb möchte ich mich zum Schluß recht herzlich bei allen Mitarbeitern des Hauses bedanken und auch bei den Kollegen, weil man sieht, daß wir auch gerne bereit sind, Verantwortung außerhalb Europas zu übernehmen, daß wir uns Gedanken machen um den Frieden in dieser Welt.	Firstly, the necessary reforms within the institutions and the EU Member States.
Deshalb ist es mir auch eine besondere Freude, daß wir gestern unserer Präsidentin das Friedenslicht aus Bethlehem überreichen konnten.	Secondly, the enlargement of the European Union of the 15 and the associated discussion about the borders of Europe and the European Union, which we demanded, and which has been taken up by President Prodi.
Ich hoffe, daß uns dieser Frieden in der Weihnachtszeit begleitet und wir eine Chance haben, auch im neuen Jahrtausend in Frieden zu leben!	Thirdly, the role of a self-assured, dynamic European Union in the world.
Herr Präsident!	Fourthly, boosting public confidence in the realisation of these goals and in our work.
Wenn es das tadschikische Volk nicht gäbe, dann stünde ich heute nicht hier!	Extending a special financial aid package to Tajikistan is part of the growing responsibility we have for the democratic and peaceful development of world politics based on the recognition of human rights.
Mein Großvater war als Kriegsgefangener im Ersten Weltkrieg 1916 im damaligen Russisch-Zentralasien zum Eisenbahnbau.	The extraordinary financial aid package for Armenia and Georgia adopted on 17 November 1997 also allowed for the possibility of providing Tajikistan with a similar aid package, as soon as this country - to amplify the comments made by Paul Rübig - reaches agreement with the IMF.
Und er hat mir immer erzählt, daß er diese schweren Jahre nur aufgrund der Gastfreundschaft und Hilfsbereitschaft des tadschikischen Volkes überlebt hat.	This agreement is now in place.
Dies ist aber nicht der Grund, warum ich mich heute so für Tadschikistan einsetze, sondern im Gegensatz zum Kollegen Blokland bin ich schon der Meinung, daß das eine Frage ist, die uns unmittelbar angeht.	Following two emergency loans, which were granted after the conflict in December 1997 and April 1998, the IMF approved a three-year programme for Tajikistan worth USD 128 million in June 1998, in order to consolidate the stabilisation successes and achieve sustained growth.
Tadschikistan liegt in einem Raum, der eingegrenzt wird von China und Rußland, die dort zusammenstoßen, der islamischen Welt und dem Kaspischen Meer, wo gewaltige Rohstoffvorkommen sind.	In addition, on 11 December 1998, on the initiative of the IMF and the World Bank, a meeting of the Consultative Group was called in order to improve access to the financial facilities that these institutions provide for the benefit of Tajikistan and other Newly Independent States particularly hard hit by the external effects of the Russian crisis.
Meines Erachtens ist dieser Raum der Balkan der Zukunft, ein Balkan im Weltmaßstab.	That is why it is right and proper, for the sake of our own needs, but also of our responsibility on the world political scene, which will undoubtedly increase, to lend our support to this report, together with the amendments today.
Und deshalb ist es unser Lebensinteresse, zumal dort auch eine Reihe von Atommächten angesiedelt ist, diesen Raum zu stabilisieren und zu verhindern, daß sich ethnische Konflikte dort auf die ganze Welt auswirken.	Finally, permit me, as I am the last speaker and also as I am a newcomer amongst the last speakers in this Parliament, to provide a little more food for thought.
Deshalb glaube ich, daß es notwendig ist, Tadschikistan auf seinem schweren Weg zu helfen, durch einen Kredit, aber auch durch verlorene Zuschüsse, wobei klar ist, daß wir uns deshalb an die Mitgliedstaaten wenden müssen, weil dies unser Haushalt nicht hergibt.	Firstly, I would just like to make clear, and I believe I am expressing exactly what many people feel here, that I am pleased, that we are pleased, to be able to participate in this process here in this Parliament.
Wir sollten natürlich Demokratie und Rechtsstaatlichkeit einfordern, aber wir sollten auch keine ungerechten Maßstäbe anlegen.	Secondly, although we know where there is still room for improvement, we are doing sound work that is growing in importance.
Tadschikistan wurde jahrhundertelang kolonial ausgeplündert.	We can only do this work, however, because we are accompanied and supported by competent, committed, reliable colleagues and parliamentary employees in our groups and in our committees as well as in the course of everyday parliamentary life.
Es wurde 80 Jahre lang vom Sowjet-Kommunismus brutal unterdrückt.	Thank you to all those who support us and assist us in our work!
Heute geht dieses kleine Bergvolk mühsam seinen Weg, und da können wir nicht europäische Maßstäbe anlegen.	I would like to express two further wishes, since we are fast approaching Christmas.
Da müssen wir Maßstäbe anlegen wie bei Entwicklungsländern, wobei auch die Länder Afrikas, wo es noch viel zu beklagen gibt, immerhin seit Jahrzehnten von uns unterstützt werden auf dem Weg die Demokratie.	Let us make a greater success in the New Year of giving home affairs in the Member States a more European flavour.
Tadschikistan wird erst seit wenigen Jahren unterstützt.	Let us make a greater success in the New Year of fixing our work in the consciousness of the Member States and of the citizens.
Deshalb müssen wir natürlich Spielregeln einfordern, aber wir sollten Geduld haben mit dem tadschikischen Volk, wir sollten die Wahlen im Frühling massiv fördern und wir sollten erkennen, daß dies nicht nur eine Tat ist, die Europa zur Ehre gereicht, sondern daß es auch im ureigensten Interesse Europas ist, für Frieden in dieser Region zu sorgen.	On behalf of my group I would like to wish all those with whom I work and my fellow parliamentarians a Happy Christmas!
Herr Präsident, Frau Kommissarin, meine sehr geehrten Damen und Herren!	(Applause)
Die Europäische Union hat sich vier große Ziele gesetzt.	Mr President, ladies and gentlemen, first of all, a warm thank you to rapporteur Savary.
Erstens: Die notwendigen Reformen innerhalb der Institutionen und der Mitgliedstaaten der EU.	The Commission is very pleased to note that its proposal to grant exceptional financial aid to Tajikistan has obtained wholehearted support from Parliament' s relevant committee.
Zweitens: Die Erweiterung der Europäischen Union der 15 und die damit verbundene, von uns geforderte und von Präsident Prodi aufgegriffene Diskussion über die Grenzen Europas und der Europäischen Union.	The Commission is supporting quite a lot of the proposed amendments, especially those relating to stricter Budget supervision (given the possibility of retrograde political developments in the country) and is also supporting the proposal that a final report should be delivered to Parliament in the year 2004.
Drittens: Die Rolle einer selbstbewußten dynamischen Europäischen Union in der Welt.	The Commission cannot, however, accept the proposals regarding that part of the aid relating to subsidies.
Viertens: Die Stärkung des Vertrauens der Bürger in die Verwirklichung dieser Ziele und in unsere Arbeit.	It is impossible to implement this part relating to subsidies on existing legal bases, especially TACIS, because the resources included in the aid cannot be related to special projects or programmes.
Die Einbeziehung von Tadschikistan in eine Sonderfinanzhilfe gehört zu dieser unserer wachsenden Verantwortung für eine demokratische, friedliche, auf der Akzeptanz der Menschenrechte basierende weltpolitische Entwicklung.	The aim is in fact to reduce the country' s debt towards the Community.
Die am 17. November 1997 angenommene außerordentliche Finanzhilfe an Armenien und Georgien beinhaltete auch die Möglichkeit einer ähnlichen Hilfe für Tadschikistan, sobald dieses Land - ergänzend zu den Bemerkungen von Paul Rübig - zu einer Einigung mit dem IWF gekommen ist.	This proposal is also aimed at confirming the subsidy of EUR 95 million available to Armenia and Georgia in accordance with Council Decision 97/787/EC of 17 November 1997.
Diese Einigung mit dem Internationalen Währungsfonds ist gegeben.	The Commission finds it difficult to accept a reduction of the subsidy to EUR 50 million.
Nach zwei Sofortkrediten, die nach dem Konflikt im Dezember 1997 und April 1998 gewährt wurden, bewilligte der IWF im Juni 1998 ein dreijähriges Programm zugunsten Tadschikistans im Gegenwert von 128 Millionen US-Dollar, um die Stabilisierungserfolge zu festigen und ein nachhaltiges Wachstum zu erreichen.	The reasons for this are as follows.
Ferner wurde am 11. Dezember 1998 auf Initiative des IWF und der Weltbank eine Sitzung der Beratenden Gruppe einberufen, um den Zugang zu den Finanzierungsfazilitäten, die diese Institutionen zugunsten von Tadschikistan und anderen, von den externen Effekten der Rußlandkrise besonders betroffenen NUS anbieten, zu verbessern.	The Community' s financial exposure will continue to be high in an area whose stability has deteriorated, both because of the Russian financial crisis and the current situation in the northern Caucasus.
Daher ist es gut und richtig, im Sinne unserer Bedingungen, aber auch unserer weltpolitischen Verantwortung, die zweifelsohne zunehmen wird, dem Bericht heute unsere Zustimmung mit den Abänderungen zu geben.	A significant reduction in the EU' s exposure has already been achieved, with the figure concerned going down from EUR 212 million initially, including interest on outstanding debts, to EUR 123 million at present.
Lassen Sie mich zum Schluß, weil ich der letzte Redner bin, und weil ich auch neu unter den letzten Rednern in diesem Parlament bin, noch ein paar Gedanken einbringen.	A further reduction may, however, occur over the next few years if the aid is implemented as planned.
Erstens: Ich möchte einmal deutlich aussprechen, und ich glaube, daß ich vielen aus der Seele spreche, daß ich froh bin, daß wir froh sind, hier in diesem Parlament an diesem Prozeß mitarbeiten zu dürfen.	Armenia and Georgia will have difficulty understanding the fact that the Community is reducing its aid, in spite of the major efforts which these two countries, with support from the IMF and other contributors, have made to reduce their financial liabilities towards the Community.
Zweitens: Obwohl wir wissen, was alles zu verbessern ist, leisten wir hier gute und zunehmend wichtige Arbeit.	This would put the Community in a difficult situation regarding both these two countries and the international community.
Wir können diese Arbeit aber nur leisten, weil wir in unseren Büros, in unseren Fraktionen, in den Ausschüssen sowie im parlamentarischen Alltag von kompetenten, engagierten, verläßlichen Mitarbeitern und Parlamentsangestellten begleitet und unterstützt werden.	The Commission considers that it would be unfortunate if the Community were to refuse to confirm its financial aid to countries whose strategic importance to the Community is obvious.
Danke an alle, die hinter uns stehen und uns bei unserer Arbeit helfen!	Moreover, we ought, in the light of the present difficulties in the Caucasus, to send out political signals indicating that we want to continue to support the considerable efforts which are being made to achieve stabilisation and democracy, as well as to introduce reforms.
Ich möchte noch zwei Wünsche äußern, weil wir vor Weihnachten stehen: Möge es uns im neuen Jahr besser gelingen, die Innenpolitik in den Mitgliedstaaten zu europäisieren.	The debate is closed.
Möge es uns im neuen Jahr besser gelingen, unsere Arbeit im Bewußtsein der Mitgliedstaaten und der Bürger zu verankern.	We shall now proceed to the vote.
Im Namen meiner Fraktion möchte ich allen Mitarbeitern und parlamentarischen Kollegen ein frohes Weihnachtsfest wünschen!	Following the vote on the amendments
(Beifall)	Mr President, after the voting, I would like to raise a point of order concerning the texts adopted yesterday.
Herr Präsident, sehr geehrte Abgeordnete!	If you would allow me, I would like to take up a few minutes after the votes.
Zuerst möchte ich dem Berichterstatter Herrn Savary meinen herzlichen Dank aussprechen.	You may do so.
Die Kommission hat mit Freude wahrgenommen, daß sein Vorschlag zur Bewilligung einer Sonderfinanzhilfe für Tadschikistan voll und ganz vom Parlamentsausschuß unterstützt wird.	(Parliament approved the legislative resolution) EXPLANATIONS OF VOTE
Mehrere der beantragten Änderungen werden von der Kommission unterstützt, insbesondere diejenigen, die eine strengere Haushaltskontrolle im Hinblick auf eine möglicherweise negative politische Entwicklung im Land befürworten sowie auch der Vorschlag eines im Jahr 2004 dem Parlament vorzulegenden abschließenden Berichts.	Mr President, I would like to say how pleased I am to give this last explanation of vote of 1999 on the Savary report, which I voted for.
Die Kommission kann jedoch dem Änderungsantrag im Hinblick auf die Zuschußkomponente der Finanzhilfe nicht zustimmen.	I am very much in favour of this European Community initiative which aims to grant practical aid to the most deserving regions, such as Tajikistan.
Diese Zuschußkomponente kann aufgrund der bestehenden Rechtsgrundlagen, insbesondere des TACIS-Programms, nicht gewährt werden, weil die Mittel der Finanzhilfe nicht zu bestimmten Projekten oder Programmen in Beziehung gesetzt werden können.	I would like, as Mr Blokland said in his statement, to say to Commissioner Wallström - who is disturbing the sleep of Italian, Greek and Spanish pensioners because of superannuated cars which have to be quickly taken off the roads - that I would appreciate verification as to how the aid is distributed once it has been granted to Tajikistan and other States.
Ziel ist es ja, die Schulden dieses Lands gegenüber der Gemeinschaft zu reduzieren.	I would be pleased if it was given to people who need it, such as pensioners.
Dieser Vorschlag zielt auch darauf ab, den Zuschuß in Höhe von 95 Millionen Euro für Armenien und Georgien laut Beschluß des Rats 97/787/EG vom 17. November 1997 zu bestätigen.	Mr President, despite having some serious concerns, I voted in favour of the financial aid package because I see in it an opportunity to establish a market economy, democracy and peace using financial incentives, of the kind put forward by Mr Karas, rather than force.
Die Zuschußkürzung auf 50 Millionen Euro ist für die Kommission schwer zu akzeptieren.	I would like to extend my heartfelt thanks to all those fellow MEPs who gave me their support in this and would like to wish you all a merry Christmas and Happy New Year!
Und zwar aus folgenden Gründen: Die finanziellen Zuwendungen der Gemeinschaft werden weiterhin in beachtlicher Höhe in einem Gebiet erfolgen, in dem die Stabilität sowohl aufgrund der Finanzkrise in Rußland als auch durch die aktuelle Situation im nördlichen Kaukasus gefährdet ist.	Mr President, very briefly on a point of order regarding the texts adopted yesterday.
Eine unfangreiche Kürzung der Zuwendungen der EU ist bereits von ursprünglich 212 Millionen Euro, einschließlich der Zinsen auf bestehende Schulden, auf zur Zeit 123 Millionen Euro erfolgt.	During the debate, I was watching what exactly was written down regarding the vote for the Murphy report on late payment.
Während der kommenden Jahre kann es jedoch zu einer weiteren Kürzung kommen, falls die Zuschüsse wie geplant gewährt werden.	I would like to ask you to get your department to look at Amendment No 20 again, as I am 99.9% certain that this is not the text we voted on or at any rate not the text which should have been submitted because this is not what the Industry Committee provided.
Für Armenien und Georgien ist die Zuschußkürzung der Gemeinschaft schwer einsehbar, da diese beiden Länder mit Hilfe des IWF und anderer Geber große Anstrengungen unternommen haben, um ihre finanziellen Verpflichtungen gegenüber der Gemeinschaft abzubauen.	I have asked to be given the floor officially because I fear that we will be unable to reach the departments during the Christmas break and in order to avoid problems during the conciliation procedure.
Dies würde die Union sowohl diesen beiden Ländern als auch der internationalen Gemeinschaft gegenüber in eine schwierige Lage versetzen.	Thank you very much, Mrs Thyssen.
Nach Auffassung der Kommission wäre es bedauerlich, würde die Union nicht ihre finanzielle Hilfe für die Länder, deren strategische Bedeutung für die Gemeinschaft offensichtlich ist, bestätigen.	We will make the appropriate checks because, evidently, the Minutes have been approved; therefore, there will have to be a technical correction where appropriate.
Unter dem Eindruck der aktuellen problematischen Lage im Kaukasus sollten wir des weiteren politische Signale setzen, die erkennen lassen, daß wir die vehementen Bemühungen um Stabilisierung, Demokratie und Reformen weiterhin unterstützen wollen.	Mr President, I do not know if this is a technical correction, but I have just discovered that I am not included in the Members from Luxembourg in Wednesday' s Minutes, concerning Mrs Palacio Vallelersundi' s report on the verification of credentials.
Die Aussprache ist geschlossen.	Mrs Reding' s name is there instead.
Wir kommen nun zur Abstimmung.	I know that I owe my seat to her being appointed a Commissioner but I do not understand, since I have been a Member of this Parliament since 16 September, why my name does not feature in the Minutes covering the verification of credentials.
Nach der Abstimmung über die Änderungsanträge	Would you please rectify this?
Herr Präsident!	Mrs Lulling, I cannot rectify this because this report does not affect you.
Nach der Abstimmung habe ich noch eine Anmerkung zum Verfahren betreffend die gestern angenommenen Texte.	You were elected on 16 September - as you quite rightly said - and this report concerns those who were elected on 13 June.
Ich möchte mit Ihrer Erlaubnis gleich nach der Abstimmung kurz um das Wort bitten.	You replaced Mrs Reding.
Einverstanden.	There will therefore be another report, which will, I hope, confirm your mandate.
(Das Parlament nimmt die legislative Entschließung an.)	Mr President, as it is now Christmas, I would be grateful if you would allow me to speak for a moment.
Erklärungen zur Abstimmung	I would like to thank you and clear up a misunderstanding.
Herr Präsident, mit dieser für 1999 letzten Abstimmungserklärung zu dem Bericht von Herrn Savary, für den ich gestimmt habe, möchte ich meine große Genugtuung zum Ausdruck bringen.	The President is entitled to allow an MEP to ask a question of the Commission.
Diese Maßnahme der Europäischen Union, mit der den bedürftigsten Regionen wie Tadschikistan eine konkrete Hilfe gewährt werden soll, wird von mir in höchstem Maße befürwortet.	I wanted to ask the Commissioner a question and also answer a question that you asked of Mr Mayer.
Wie Herr Blokland in seinen Ausführungen möchte ich der Kommissarin, Frau Wallström, - die den Rentnern in Italien, Griechenland und Spanien wegen Altautos, die schnell aus dem Verkehr gezogen werden sollen, schlaflose Nächte bereitet - sagen, daß ich es begrüßen würde, wenn die für Tadschikistan und andere Staaten bereitgestellten Hilfen auch im Hinblick auf ihren Verwendungszeck kontrolliert würden.	I wanted to say that in the spring there will be a large beer-tasting session for Bavarian beer in the Parliament courtyard here in Strasbourg.
Es wäre mir eine Freude, wenn sie auch für Personen bestimmt würden, die ihrer bedürfen, wie die Rentner.	Mr Posselt, I am very pleased, but in any case, I would remind you that, when requesting a procedural motion, you actually have to indicate the Rule to which you are referring.
Sehr geehrter Herr Präsident!	Having said that, Parliament has reached the end of the agenda.
Ich habe trotz großer Bedenken für die Finanzhilfe gestimmt, weil ich eine Chance sehe, mit Finanzanreizen, so wie sie Herr Karas vorgetragen hat, und nicht mit Gewalt Marktwirtschaft, Demokratie und Frieden herzustellen.	The Minutes of the present sitting will be subject to Parliament' s approval at the beginning of the next part-session.
Ich möchte allen Kollegen recht herzlich danken, die mich hier unterstützt haben, möchte frohe Weihnachten wünschen und ein gutes Neues Jahr!	Mr Manders has the floor for a procedural motion.
Herr Präsident!	Mr President, I would like to take this opportunity to wish you, the Bureau and all Members, a good transition into the new year.
Ganz kurz zu den gestern angenommenen Texten.	Ladies and gentlemen, before you leave me alone, I would like on behalf of the Bureau, once again, to thank all the Members, all the services, officials, assistants and other co-workers and, if you will allow me - although all the co-workers work for us - perhaps a special mention should go to the language services which help us to understand each other here.
Ich habe während der Debatte geschaut, was hier genau über die Abstimmung zum Bericht Murphy über den Zahlungsrückstand aufgeschrieben wurde.	I would also like, although they are absent, to mention the Commission and the Council.
Ich möchte Sie bitten, Ihre Dienste zu beauftragen, Änderungsantrag 20 zu überprüfen.	I am not going to re-open the 'Millennium or not the Millennium' debate, but I am going to wish all of you, and by extension, all the citizens of Europe which we represent, a happy year 2000.
Denn ich bin zu 99,9 % sicher, daß das nicht der Text ist, über den wir abgestimmt haben, beziehungsweise nicht der Text, der hier hätte vorliegen sollen, denn das ist nicht das, was der Ausschuß für Industrie, Außenhandel, Forschung und Energie eingereicht hat.	Adjournment of the session
Ich habe offiziell um das Wort gebeten, da ich befürchte, die Dienste sind während der Weihnachtspause nicht mehr zu erreichen, und außerdem soll es beim Vermittlungsverfahren keine Schwierigkeiten geben.	I declare the session of the European Parliament adjourned.
Vielen Dank, Frau Thyssen.	(The sitting was closed at 10.50 a.m.)
